RA,E,Q,U,X,A,RI,size,t
100,100,0,0,0,10,0,210,0
101,100,1,0,0,9,0,211,0.005
102,100,2,0,0,8,0,212,0.01
104,100,3,0,0,7,0,214,0.015
104,100,3,0,0,7,0,214,0.02
104,101,3,0,1,7,0,216,0.025
106,101,4,0,1,8,0,220,0.03
108,101,5,0,1,7,0,222,0.035
109,101,5,0,1,9,0,225,0.04
109,101,8,0,1,7,0,226,0.045
109,102,9,0,1,6,0,227,0.05
109,103,10,0,1,6,0,229,0.055
111,105,11,0,1,3,0,231,0.06
112,105,11,0,1,2,0,231,0.065
112,106,11,0,1,4,0,234,0.07
112,106,11,0,1,8,0,238,0.075
115,107,11,0,1,5,0,239,0.08
115,109,11,0,1,5,0,241,0.085
118,109,13,0,1,3,0,244,0.09
119,110,13,0,1,4,0,247,0.095
119,112,14,0,1,1,0,247,0.1
119,113,14,0,1,0,0,247,0.105
119,113,14,0,1,3,0,250,0.11
119,113,15,0,3,1,0,251,0.115
119,114,15,0,3,1,0,252,0.12
119,114,17,0,3,0,0,253,0.125
119,114,17,0,3,1,0,254,0.13
119,114,18,0,3,4,0,258,0.135
119,115,19,0,3,5,0,261,0.14
120,115,20,0,3,5,0,263,0.145
121,115,21,0,3,8,0,268,0.15
122,115,24,0,3,4,0,268,0.155
122,118,26,0,3,3,0,272,0.16
122,119,27,0,3,1,0,272,0.165
122,120,28,0,4,3,0,277,0.17
122,122,29,0,4,3,0,280,0.175
122,122,31,0,4,4,0,283,0.18
123,123,32,0,4,4,0,286,0.185
123,124,32,0,4,5,0,288,0.19
125,124,33,0,5,5,0,292,0.195
125,124,34,0,5,5,0,293,0.2
125,127,36,0,5,0,0,293,0.205
125,127,36,0,5,0,0,293,0.21
125,127,36,0,5,1,0,294,0.215
125,127,37,0,5,0,0,294,0.22
125,127,37,0,5,1,0,295,0.225
125,127,38,0,5,2,0,297,0.23
125,129,38,0,5,1,0,298,0.235
125,129,38,0,5,3,0,300,0.24
125,131,38,0,5,2,0,301,0.245
125,131,39,0,5,4,0,304,0.25
125,131,40,0,5,5,0,306,0.255
126,131,43,0,5,3,0,308,0.26
126,131,43,0,5,7,0,312,0.265
126,133,43,0,5,6,0,313,0.27
127,135,44,0,6,8,0,320,0.275
127,136,45,0,6,8,0,322,0.28
127,137,46,0,7,8,0,325,0.285
129,137,48,0,7,6,0,327,0.29
130,138,48,0,7,5,0,328,0.295
130,139,50,0,7,4,0,330,0.3
131,139,51,0,7,3,0,331,0.305
131,140,52,0,7,6,0,336,0.31
131,141,53,0,7,4,0,336,0.315
131,142,53,0,8,6,0,340,0.32
132,144,54,0,9,5,0,344,0.325
132,145,55,0,9,8,0,349,0.33
133,145,56,0,9,8,0,351,0.335
135,146,58,0,9,5,0,353,0.34
135,147,58,0,10,4,0,354,0.345
135,148,60,0,11,1,0,355,0.35
135,148,60,0,11,4,0,358,0.355
135,151,61,0,11,2,0,360,0.36
137,151,61,0,11,5,0,365,0.365
137,152,62,0,11,4,0,366,0.37
138,153,66,0,11,2,0,370,0.375
138,154,68,0,11,1,0,372,0.38
138,154,68,0,11,2,0,373,0.385
138,154,70,0,11,2,0,375,0.39
138,154,70,0,11,6,0,379,0.395
138,154,71,0,11,7,0,381,0.4
138,155,71,0,11,7,0,382,0.405
138,155,72,0,12,7,0,384,0.41
139,157,72,0,12,6,0,386,0.415
139,157,76,0,12,4,0,388,0.42
139,162,77,0,13,5,0,396,0.425
139,163,78,0,13,6,0,399,0.43
139,166,81,0,13,1,0,400,0.435
139,166,83,0,14,1,0,403,0.44
140,168,83,0,14,2,0,407,0.445
140,169,85,0,14,3,0,411,0.45
140,170,86,0,16,0,0,412,0.455
140,171,86,0,16,2,0,415,0.46
140,172,87,0,16,1,0,416,0.465
140,172,89,0,16,2,0,419,0.47
140,173,90,0,16,4,0,423,0.475
140,175,90,0,16,6,0,427,0.48
140,175,91,0,16,7,0,429,0.485
142,176,91,0,16,5,0,430,0.49
142,180,92,0,16,4,0,434,0.495
142,181,93,0,19,3,0,438,0.5
143,182,93,0,20,5,0,443,0.505
143,183,93,0,21,7,0,447,0.51
143,186,96,0,21,4,0,450,0.515
143,186,98,0,21,5,0,453,0.52
144,188,98,0,22,6,0,458,0.525
144,188,98,0,22,11,0,463,0.53
146,188,100,0,23,13,0,470,0.535
148,189,101,0,23,11,0,472,0.54
148,190,103,0,23,13,0,477,0.545
150,190,105,0,23,15,0,483,0.55
153,190,107,0,23,13,0,486,0.555
153,190,107,0,23,17,0,490,0.56
154,192,108,0,23,16,0,493,0.565
154,192,109,0,24,18,0,497,0.57
161,192,110,0,24,17,0,504,0.575
161,192,111,0,24,20,0,508,0.58
163,192,113,0,25,21,0,514,0.585
169,192,117,0,25,17,0,520,0.59
171,194,119,0,27,12,0,523,0.595
171,194,121,0,27,15,0,528,0.6
171,197,121,0,27,13,0,529,0.605
173,198,124,0,27,10,0,532,0.61
174,198,124,0,27,15,0,538,0.615
175,199,124,0,27,17,0,542,0.62
175,199,126,0,27,21,0,548,0.625
176,199,129,0,27,22,0,553,0.63
178,200,130,0,28,18,0,554,0.635
180,202,130,0,29,14,0,555,0.64
182,204,133,0,29,10,0,558,0.645
182,204,133,0,29,12,0,560,0.65
182,205,134,0,29,13,0,563,0.655
182,206,136,0,30,14,0,568,0.66
183,207,137,0,31,12,0,570,0.665
185,209,137,0,31,12,0,574,0.67
186,212,138,0,32,10,0,578,0.675
186,212,138,0,32,13,0,581,0.68
189,212,139,0,32,18,0,590,0.685
190,213,142,0,32,15,0,592,0.69
190,215,145,0,32,18,0,600,0.695
192,216,149,0,32,14,0,603,0.7
195,216,152,0,32,14,0,609,0.705
195,217,156,0,32,14,0,614,0.71
197,219,158,0,32,10,0,616,0.715
197,220,161,0,32,9,0,619,0.72
197,224,164,0,32,7,0,624,0.725
198,226,165,0,32,3,0,624,0.73
198,227,167,0,32,1,0,625,0.735
198,228,167,0,32,1,0,626,0.74
198,229,168,0,32,1,0,628,0.745
198,230,169,0,32,1,0,630,0.75
198,230,170,0,32,4,0,634,0.755
198,231,173,0,33,2,0,637,0.76
198,231,174,0,33,3,0,639,0.765
198,232,174,0,33,2,0,639,0.77
198,232,175,0,33,3,0,641,0.775
198,233,178,0,33,4,0,646,0.78
198,233,181,0,33,3,0,648,0.785
198,236,183,0,33,5,0,655,0.79
198,237,184,0,33,6,0,658,0.795
198,237,185,0,34,9,0,663,0.8
199,238,187,0,34,11,0,669,0.805
199,239,188,0,35,15,0,676,0.81
200,240,191,0,35,14,0,680,0.815
200,240,192,0,35,18,0,685,0.82
202,241,198,0,35,14,0,690,0.825
204,243,201,0,35,10,0,693,0.83
205,245,202,0,35,10,0,697,0.835
205,247,202,0,35,10,0,699,0.84
205,248,203,0,35,11,0,702,0.845
206,250,204,0,35,10,0,705,0.85
206,252,204,0,36,8,0,706,0.855
206,253,206,0,36,8,0,709,0.86
206,253,210,0,37,5,0,711,0.865
208,255,211,0,37,8,0,719,0.87
208,258,212,0,37,11,0,726,0.875
208,261,217,0,37,5,0,728,0.88
208,263,218,0,37,10,0,736,0.885
209,266,218,0,37,11,0,741,0.89
210,268,223,0,39,6,0,746,0.895
210,268,226,0,39,9,0,752,0.9
211,270,229,0,40,4,0,754,0.905
211,272,229,0,40,6,0,758,0.91
211,272,229,0,40,11,0,763,0.915
211,273,229,0,41,14,0,768,0.92
212,273,231,0,42,18,0,776,0.925
214,273,232,0,42,20,0,781,0.93
214,274,236,0,42,21,0,787,0.935
214,276,239,0,42,20,0,791,0.94
214,277,241,0,42,18,0,792,0.945
214,280,243,0,43,15,0,795,0.95
216,280,245,0,43,18,0,802,0.955
216,282,247,0,43,17,0,805,0.96
219,282,247,0,44,18,0,810,0.965
220,282,248,0,44,20,0,814,0.97
223,284,249,0,45,17,0,818,0.975
224,286,252,0,46,13,0,821,0.98
224,287,254,0,47,18,0,830,0.985
225,287,255,0,48,18,0,833,0.99
228,289,256,0,48,15,0,836,0.995
228,290,257,0,49,19,0,843,1
229,291,259,0,49,17,0,845,1.005
231,292,262,0,49,16,0,850,1.01
232,293,263,0,49,18,0,855,1.015
232,295,266,0,51,20,0,864,1.02
233,303,270,0,52,12,0,870,1.025
233,304,271,0,53,12,0,873,1.03
234,305,273,0,53,17,0,882,1.035
234,305,274,0,53,22,0,888,1.04
234,307,276,0,54,23,0,894,1.045
235,309,280,0,55,16,0,895,1.05
236,310,285,0,56,16,0,903,1.055
236,311,287,0,56,21,0,911,1.06
237,313,290,0,56,22,0,918,1.065
238,315,291,0,57,19,0,920,1.07
238,315,293,0,57,24,0,927,1.075
241,315,294,0,58,20,0,928,1.08
242,318,295,0,59,17,0,931,1.085
242,318,295,0,61,21,0,937,1.09
243,319,299,0,61,19,0,941,1.095
244,319,305,0,61,19,0,948,1.1
245,320,307,0,62,18,0,952,1.105
246,323,308,0,63,14,0,954,1.11
247,328,309,0,63,13,0,960,1.115
248,331,309,0,64,9,0,961,1.12
248,332,310,0,64,11,0,965,1.125
248,334,313,0,64,11,0,970,1.13
248,335,314,0,65,13,0,975,1.135
250,336,317,0,65,11,0,979,1.14
251,337,319,0,65,10,0,982,1.145
251,338,321,0,65,17,0,992,1.15
251,338,323,0,66,24,0,1002,1.155
252,339,326,0,67,26,0,1010,1.16
254,340,327,0,67,27,0,1015,1.165
255,341,331,0,67,24,0,1018,1.17
258,343,333,0,69,22,0,1025,1.175
263,345,334,0,69,16,0,1027,1.18
132,159,174,0,26,9,0,500,1.185
134,161,174,0,27,6,0,502,1.19
135,161,174,0,27,10,0,507,1.195
136,163,176,0,27,8,0,510,1.2
136,164,176,0,27,10,0,513,1.205
136,167,179,0,27,7,0,516,1.21
136,167,180,0,28,11,0,522,1.215
138,168,181,0,29,6,0,522,1.22
138,168,182,0,30,6,0,524,1.225
140,169,182,0,30,7,0,528,1.23
141,171,183,0,30,6,0,531,1.235
141,172,185,0,30,9,0,537,1.24
141,173,186,0,31,6,0,537,1.245
141,173,188,0,32,8,0,542,1.25
142,177,189,0,32,5,0,545,1.255
143,178,190,0,32,7,0,550,1.26
143,178,190,0,33,11,0,555,1.265
144,178,190,0,33,14,0,559,1.27
146,178,191,0,33,13,0,561,1.275
147,178,193,0,33,20,0,571,1.28
147,179,195,0,33,21,0,575,1.285
148,179,199,0,33,18,0,577,1.29
151,179,199,0,33,19,0,581,1.295
152,179,199,0,34,17,0,581,1.3
153,180,201,0,34,15,0,583,1.305
154,180,202,0,35,13,0,584,1.31
155,181,203,0,35,12,0,586,1.315
155,182,204,0,37,14,0,592,1.32
155,183,205,0,37,13,0,593,1.325
157,183,206,0,37,13,0,596,1.33
158,186,208,0,37,10,0,599,1.335
159,188,208,0,37,13,0,605,1.34
160,188,210,0,37,15,0,610,1.345
160,190,212,0,38,14,0,614,1.35
161,192,215,0,38,17,0,623,1.355
164,193,216,0,39,15,0,627,1.36
167,195,216,0,39,11,0,628,1.365
168,195,217,0,39,11,0,630,1.37
169,196,223,0,40,5,0,633,1.375
169,196,223,0,40,9,0,637,1.38
169,196,227,0,40,8,0,640,1.385
169,198,229,0,40,4,0,640,1.39
171,198,230,0,40,3,0,642,1.395
171,198,231,0,41,3,0,644,1.4
171,198,232,0,41,4,0,646,1.405
171,199,234,0,41,7,0,652,1.41
171,200,235,0,41,7,0,654,1.415
171,202,235,0,41,6,0,655,1.42
171,203,238,0,41,4,0,657,1.425
172,204,239,0,41,2,0,658,1.43
172,204,244,0,42,3,0,665,1.435
172,205,244,0,44,1,0,666,1.44
172,206,244,0,44,5,0,671,1.445
172,207,245,0,44,7,0,675,1.45
173,207,245,0,44,8,0,677,1.455
173,207,248,0,45,10,0,683,1.46
173,210,248,0,45,9,0,685,1.465
173,212,251,0,45,7,0,688,1.47
173,213,251,0,45,9,0,691,1.475
173,214,253,0,45,7,0,692,1.48
174,215,256,0,45,5,0,695,1.485
174,216,256,0,46,9,0,701,1.49
175,219,256,0,46,10,0,706,1.495
175,221,256,0,46,13,0,711,1.5
175,221,257,0,47,14,0,714,1.505
175,224,258,0,47,15,0,719,1.51
177,224,261,0,47,14,0,723,1.515
178,225,262,0,48,14,0,727,1.52
179,226,262,0,49,12,0,728,1.525
179,227,266,0,50,8,0,730,1.53
181,227,266,0,50,9,0,733,1.535
181,230,268,0,52,5,0,736,1.54
181,232,268,0,52,10,0,743,1.545
181,233,269,0,54,12,0,749,1.55
181,234,269,0,54,15,0,753,1.555
182,236,273,0,56,11,0,758,1.56
183,238,274,0,56,11,0,762,1.565
184,238,275,0,56,15,0,768,1.57
184,238,276,0,59,13,0,770,1.575
184,239,277,0,59,16,0,775,1.58
184,239,278,0,59,21,0,781,1.585
184,240,281,0,60,21,0,786,1.59
188,241,284,0,61,14,0,788,1.595
188,244,287,0,62,14,0,795,1.6
190,246,289,0,63,14,0,802,1.605
191,247,291,0,63,15,0,807,1.61
192,248,292,0,63,14,0,809,1.615
193,248,298,0,63,16,0,818,1.62
193,248,298,0,64,20,0,823,1.625
196,249,300,0,64,17,0,826,1.63
197,250,303,0,64,14,0,828,1.635
198,254,304,0,64,14,0,834,1.64
199,255,304,0,64,16,0,838,1.645
201,257,307,0,64,12,0,841,1.65
202,259,308,0,64,10,0,843,1.655
202,259,310,0,64,11,0,846,1.66
203,259,312,0,65,18,0,857,1.665
203,261,314,0,65,14,0,857,1.67
203,261,316,0,66,21,0,867,1.675
204,264,316,0,67,20,0,871,1.68
205,266,317,0,67,21,0,876,1.685
206,267,317,0,67,25,0,882,1.69
208,268,317,0,67,29,0,889,1.695
106,141,153,0,46,16,0,462,1.7
107,141,153,0,46,16,0,463,1.705
109,141,157,0,46,12,0,465,1.71
109,142,157,0,47,12,0,467,1.715
110,142,157,0,47,12,0,468,1.72
110,143,158,0,47,12,0,470,1.725
110,143,160,0,49,11,0,473,1.73
111,144,160,0,49,12,0,476,1.735
111,144,161,0,49,14,0,479,1.74
112,144,162,0,49,15,0,482,1.745
116,146,163,0,49,11,0,485,1.75
117,148,164,0,50,8,0,487,1.755
117,149,165,0,51,6,0,488,1.76
118,151,165,0,51,6,0,491,1.765
118,151,167,0,51,5,0,492,1.77
118,153,167,0,51,7,0,496,1.775
118,153,168,0,51,6,0,496,1.78
119,153,172,0,51,4,0,499,1.785
120,153,172,0,51,8,0,504,1.79
120,155,173,0,51,8,0,507,1.795
121,156,173,0,51,8,0,509,1.8
122,157,176,0,52,9,0,516,1.805
125,158,177,0,52,12,0,524,1.81
125,159,177,0,53,18,0,532,1.815
125,159,177,0,53,19,0,533,1.82
125,159,177,0,53,22,0,536,1.825
125,159,180,0,53,21,0,538,1.83
126,159,181,0,54,19,0,539,1.835
126,159,183,0,54,18,0,540,1.84
126,162,184,0,54,16,0,542,1.845
127,163,184,0,55,16,0,545,1.85
128,163,186,0,55,15,0,547,1.855
128,163,187,0,55,17,0,550,1.86
131,164,187,0,55,18,0,555,1.865
133,167,187,0,55,14,0,556,1.87
133,169,187,0,56,16,0,561,1.875
134,170,188,0,56,21,0,569,1.88
134,171,190,0,56,21,0,572,1.885
135,171,193,0,56,21,0,576,1.89
135,171,193,0,56,22,0,577,1.895
138,171,193,0,56,22,0,580,1.9
139,171,194,0,57,22,0,583,1.905
140,172,195,0,57,21,0,585,1.91
140,173,196,0,57,20,0,586,1.915
143,173,199,0,57,16,0,588,1.92
143,173,199,0,57,20,0,592,1.925
145,173,202,0,58,18,0,596,1.93
147,173,204,0,59,14,0,597,1.935
147,173,210,0,59,14,0,603,1.94
148,173,210,0,59,18,0,608,1.945
148,173,213,0,59,20,0,613,1.95
149,174,214,0,59,21,0,617,1.955
151,174,216,0,59,21,0,621,1.96
153,175,218,0,60,19,0,625,1.965
155,176,219,0,61,15,0,626,1.97
155,177,220,0,63,16,0,631,1.975
156,177,221,0,66,14,0,634,1.98
159,179,223,0,66,9,0,636,1.985
160,180,224,0,66,7,0,637,1.99
161,180,225,0,66,7,0,639,1.995
161,180,226,0,66,10,0,643,2
164,181,226,0,66,8,0,645,2.005
165,183,227,0,67,7,0,649,2.01
165,183,229,0,67,7,0,651,2.015
167,185,230,0,67,3,0,652,2.02
167,186,232,0,67,3,0,655,2.025
167,187,233,0,69,2,0,658,2.03
167,188,233,0,69,2,0,659,2.035
167,189,233,0,69,6,0,664,2.04
167,191,236,0,69,5,0,668,2.045
93,96,130,0,36,3,0,358,2.05
93,96,131,0,36,3,0,359,2.055
94,96,132,0,37,2,0,361,2.06
94,96,133,0,37,1,0,361,2.065
94,97,133,0,37,1,0,362,2.07
94,98,133,0,37,1,0,363,2.075
94,98,133,0,37,2,0,364,2.08
94,99,134,0,37,0,0,364,2.085
94,99,134,0,37,2,0,366,2.09
94,100,134,0,37,2,0,367,2.095
94,100,134,0,37,4,0,369,2.1
94,100,135,0,37,5,0,371,2.105
94,100,136,0,37,6,0,373,2.11
94,100,137,0,37,8,0,376,2.115
94,100,137,0,37,9,0,377,2.12
96,100,137,0,37,8,0,378,2.125
96,101,137,0,38,6,0,378,2.13
97,101,137,0,38,7,0,380,2.135
97,102,137,0,38,7,0,381,2.14
97,103,138,0,38,8,0,384,2.145
97,104,139,0,38,7,0,385,2.15
97,104,140,0,38,11,0,390,2.155
98,104,142,0,38,10,0,392,2.16
98,105,144,0,38,9,0,394,2.165
100,106,144,0,38,7,0,395,2.17
101,109,144,0,38,6,0,398,2.175
102,109,144,0,38,6,0,399,2.18
102,109,146,0,38,6,0,401,2.185
103,109,146,0,38,7,0,403,2.19
103,109,147,0,38,6,0,403,2.195
103,110,147,0,39,7,0,406,2.2
103,111,149,0,39,4,0,406,2.205
103,111,149,0,39,7,0,409,2.21
104,111,150,0,39,6,0,410,2.215
104,112,151,0,39,6,0,412,2.22
104,113,151,0,39,8,0,415,2.225
105,115,152,0,39,8,0,419,2.23
105,117,153,0,40,9,0,424,2.235
105,117,154,0,40,10,0,426,2.24
106,118,156,0,40,9,0,429,2.245
106,119,157,0,40,10,0,432,2.25
107,120,159,0,40,10,0,436,2.255
107,120,159,0,40,11,0,437,2.26
107,120,164,0,41,10,0,442,2.265
107,120,164,0,41,12,0,444,2.27
107,120,166,0,41,10,0,444,2.275
108,120,168,0,41,11,0,448,2.28
108,120,169,0,41,10,0,448,2.285
108,121,170,0,42,12,0,453,2.29
108,121,171,0,42,13,0,455,2.295
108,125,171,0,43,9,0,456,2.3
109,126,172,0,44,8,0,459,2.305
110,126,173,0,44,7,0,460,2.31
110,127,174,0,44,9,0,464,2.315
111,127,174,0,44,12,0,468,2.32
112,128,174,0,44,13,0,471,2.325
112,129,175,0,44,14,0,474,2.33
113,129,175,0,46,13,0,476,2.335
113,130,175,0,46,14,0,478,2.34
114,132,176,0,46,14,0,482,2.345
116,133,176,0,47,10,0,482,2.35
116,134,176,0,47,10,0,483,2.355
119,135,177,0,47,8,0,486,2.36
121,136,178,0,48,9,0,492,2.365
122,136,178,0,48,9,0,493,2.37
122,136,179,0,48,8,0,493,2.375
122,138,179,0,48,9,0,496,2.38
122,141,181,0,48,5,0,497,2.385
122,142,181,0,48,8,0,501,2.39
123,142,182,0,48,10,0,505,2.395
125,143,183,0,48,8,0,507,2.4
125,144,184,0,48,10,0,511,2.405
126,146,184,0,49,8,0,513,2.41
126,147,186,0,49,6,0,514,2.415
126,148,186,0,49,8,0,517,2.42
127,148,192,0,49,4,0,520,2.425
127,148,192,0,49,5,0,521,2.43
128,148,193,0,49,8,0,526,2.435
129,148,194,0,49,10,0,530,2.44
131,151,194,0,49,9,0,534,2.445
131,153,194,0,49,9,0,536,2.45
131,153,195,0,49,11,0,539,2.455
131,154,196,0,49,16,0,546,2.46
131,154,197,0,49,20,0,551,2.465
131,155,197,0,49,22,0,554,2.47
132,155,200,0,49,23,0,559,2.475
133,155,201,0,49,23,0,561,2.48
134,155,201,0,49,23,0,562,2.485
135,155,203,0,49,24,0,566,2.49
138,155,204,0,49,24,0,570,2.495
140,155,206,0,50,22,0,573,2.5
140,155,207,0,50,24,0,576,2.505
140,157,213,0,51,17,0,578,2.51
141,160,215,0,51,14,0,581,2.515
142,161,218,0,51,14,0,586,2.52
142,161,218,0,51,16,0,588,2.525
143,162,218,0,51,17,0,591,2.53
146,165,218,0,51,14,0,594,2.535
149,165,219,0,51,14,0,598,2.54
152,167,220,0,51,11,0,601,2.545
154,171,220,0,51,6,0,602,2.55
154,171,221,0,51,7,0,604,2.555
155,171,222,0,51,8,0,607,2.56
156,171,223,0,51,10,0,611,2.565
156,172,225,0,51,12,0,616,2.57
157,173,228,0,51,8,0,617,2.575
157,174,228,0,51,9,0,619,2.58
158,175,228,0,51,9,0,621,2.585
159,176,231,0,51,11,0,628,2.59
159,179,232,0,51,9,0,630,2.595
159,181,232,0,52,11,0,635,2.6
159,182,233,0,53,8,0,635,2.605
159,184,234,0,53,6,0,636,2.61
159,187,234,0,53,5,0,638,2.615
160,189,235,0,53,7,0,644,2.62
161,190,236,0,53,4,0,644,2.625
161,192,237,0,53,3,0,646,2.63
161,193,238,0,53,4,0,649,2.635
161,194,240,0,53,7,0,655,2.64
163,196,241,0,53,6,0,659,2.645
163,199,242,0,53,6,0,663,2.65
163,199,243,0,53,8,0,666,2.655
163,202,243,0,54,9,0,671,2.66
164,204,245,0,56,6,0,675,2.665
164,204,245,0,56,10,0,679,2.67
165,206,245,0,57,10,0,683,2.675
166,206,249,0,58,5,0,684,2.68
166,209,250,0,59,7,0,691,2.685
166,209,254,0,59,4,0,692,2.69
166,210,254,0,60,5,0,695,2.695
166,211,255,0,61,7,0,700,2.7
166,212,256,0,61,8,0,703,2.705
167,212,256,0,62,12,0,709,2.71
167,214,257,0,62,12,0,712,2.715
167,215,259,0,63,13,0,717,2.72
168,215,259,0,63,18,0,723,2.725
168,216,260,0,63,22,0,729,2.73
169,217,263,0,63,21,0,733,2.735
171,218,263,0,63,20,0,735,2.74
173,218,264,0,64,17,0,736,2.745
175,218,268,0,64,13,0,738,2.75
176,220,269,0,65,12,0,742,2.755
177,221,271,0,65,10,0,744,2.76
177,224,274,0,65,8,0,748,2.765
177,224,275,0,65,9,0,750,2.77
178,225,277,0,66,9,0,755,2.775
179,225,278,0,66,11,0,759,2.78
180,227,278,0,66,11,0,762,2.785
180,227,278,0,66,16,0,767,2.79
181,229,280,0,66,14,0,770,2.795
182,229,283,0,66,13,0,773,2.8
182,229,284,0,67,15,0,777,2.805
182,229,285,0,68,18,0,782,2.81
185,229,285,0,68,19,0,786,2.815
185,229,287,0,68,21,0,790,2.82
189,231,287,0,69,17,0,793,2.825
93,118,145,0,40,12,0,408,2.83
95,118,145,0,40,10,0,408,2.835
95,119,145,0,40,12,0,411,2.84
95,120,146,0,40,15,0,416,2.845
96,121,151,0,41,9,0,418,2.85
96,122,152,0,41,7,0,418,2.855
96,124,152,0,41,7,0,420,2.86
97,124,153,0,41,7,0,422,2.865
97,125,154,0,42,8,0,426,2.87
97,125,154,0,43,10,0,429,2.875
97,125,155,0,43,11,0,431,2.88
97,126,156,0,43,11,0,433,2.885
97,126,157,0,43,11,0,434,2.89
97,127,157,0,43,16,0,440,2.895
101,128,157,0,44,12,0,442,2.9
104,129,157,0,44,13,0,447,2.905
105,129,158,0,44,13,0,449,2.91
107,131,158,0,44,9,0,449,2.915
108,131,162,0,44,5,0,450,2.92
108,131,163,0,44,6,0,452,2.925
109,133,164,0,44,3,0,453,2.93
109,133,164,0,44,4,0,454,2.935
109,133,164,0,45,6,0,457,2.94
109,133,165,0,45,8,0,460,2.945
109,133,167,0,46,7,0,462,2.95
110,133,168,0,46,7,0,464,2.955
110,133,168,0,47,9,0,467,2.96
110,134,171,0,47,8,0,470,2.965
111,138,172,0,48,3,0,472,2.97
111,139,173,0,49,5,0,477,2.975
111,139,175,0,49,6,0,480,2.98
111,140,177,0,49,5,0,482,2.985
111,140,179,0,49,4,0,483,2.99
111,140,181,0,49,3,0,484,2.995
111,140,182,0,49,4,0,486,3
111,140,183,0,50,4,0,488,3.005
111,142,183,0,50,7,0,493,3.01
111,143,183,0,50,8,0,495,3.015
111,143,186,0,50,7,0,497,3.02
112,145,187,0,51,4,0,499,3.025
112,148,189,0,52,2,0,503,3.03
112,149,189,0,52,6,0,508,3.035
112,150,189,0,54,7,0,512,3.04
112,150,190,0,54,9,0,515,3.045
113,150,191,0,54,8,0,516,3.05
114,151,192,0,55,9,0,521,3.055
114,151,193,0,55,9,0,522,3.06
114,155,193,0,55,6,0,523,3.065
115,155,194,0,55,6,0,525,3.07
115,158,194,0,55,4,0,526,3.075
115,160,194,0,55,2,0,526,3.08
116,160,194,0,55,3,0,528,3.085
116,161,194,0,55,4,0,530,3.09
116,162,194,0,57,3,0,532,3.095
116,163,195,0,58,6,0,538,3.1
116,164,196,0,58,8,0,542,3.105
116,166,197,0,59,7,0,545,3.11
116,167,198,0,59,6,0,546,3.115
117,167,200,0,60,3,0,547,3.12
117,167,200,0,60,6,0,550,3.125
118,168,201,0,60,6,0,553,3.13
119,171,202,0,60,3,0,555,3.135
119,171,202,0,61,5,0,558,3.14
119,172,203,0,61,5,0,560,3.145
121,173,204,0,61,3,0,562,3.15
121,174,205,0,61,2,0,563,3.155
121,175,206,0,61,2,0,565,3.16
121,175,206,0,61,5,0,568,3.165
121,178,207,0,61,8,0,575,3.17
121,181,209,0,61,3,0,575,3.175
121,181,209,0,61,6,0,578,3.18
121,182,210,0,62,6,0,581,3.185
121,184,211,0,62,6,0,584,3.19
122,186,211,0,62,5,0,586,3.195
122,186,212,0,62,8,0,590,3.2
122,188,215,0,62,4,0,591,3.205
122,190,215,0,62,3,0,592,3.21
122,192,215,0,62,7,0,598,3.215
122,192,215,0,62,7,0,598,3.22
123,193,216,0,62,4,0,598,3.225
123,194,217,0,62,6,0,602,3.23
124,195,217,0,62,8,0,606,3.235
124,196,219,0,62,11,0,612,3.24
124,197,220,0,62,13,0,616,3.245
125,197,220,0,63,15,0,620,3.25
125,199,223,0,63,11,0,621,3.255
126,199,225,0,64,9,0,623,3.26
126,199,225,0,64,14,0,628,3.265
128,199,226,0,64,16,0,633,3.27
130,200,228,0,64,13,0,635,3.275
131,200,229,0,64,16,0,640,3.28
132,200,232,0,64,13,0,641,3.285
132,202,233,0,64,14,0,645,3.29
133,203,233,0,64,14,0,647,3.295
134,205,234,0,64,12,0,649,3.3
135,205,234,0,65,11,0,650,3.305
136,205,235,0,65,11,0,652,3.31
136,205,236,0,65,12,0,654,3.315
136,207,238,0,65,9,0,655,3.32
136,208,240,0,67,4,0,655,3.325
136,209,241,0,68,3,0,657,3.33
137,210,242,0,68,4,0,661,3.335
138,211,244,0,68,1,0,662,3.34
138,211,244,0,68,6,0,667,3.345
68,104,116,0,40,7,0,335,3.35
69,105,117,0,40,5,0,336,3.355
69,105,119,0,40,3,0,336,3.36
69,105,119,0,40,5,0,338,3.365
70,105,121,0,40,5,0,341,3.37
71,105,121,0,41,4,0,342,3.375
71,105,121,0,41,6,0,344,3.38
72,105,122,0,41,7,0,347,3.385
72,106,122,0,41,9,0,350,3.39
72,107,122,0,42,10,0,353,3.395
73,107,122,0,43,8,0,353,3.4
73,108,122,0,43,7,0,353,3.405
73,109,123,0,43,8,0,356,3.41
74,109,123,0,43,9,0,358,3.415
75,110,123,0,43,8,0,359,3.42
75,110,124,0,43,9,0,361,3.425
75,111,124,0,43,9,0,362,3.43
75,111,126,0,43,8,0,363,3.435
75,112,127,0,44,9,0,367,3.44
75,112,127,0,44,11,0,369,3.445
75,112,127,0,44,12,0,370,3.45
75,112,129,0,44,13,0,373,3.455
76,112,129,0,45,12,0,374,3.46
76,112,129,0,46,12,0,375,3.465
78,112,129,0,47,10,0,376,3.47
78,113,131,0,47,11,0,380,3.475
78,113,134,0,47,13,0,385,3.48
78,113,135,0,47,14,0,387,3.485
78,115,136,0,47,13,0,389,3.49
79,115,136,0,47,13,0,390,3.495
79,115,137,0,47,12,0,390,3.5
79,116,138,0,47,11,0,391,3.505
79,116,138,0,47,12,0,392,3.51
80,116,138,0,47,15,0,396,3.515
81,116,139,0,47,17,0,400,3.52
82,117,140,0,47,17,0,403,3.525
82,117,142,0,47,16,0,404,3.53
83,117,143,0,48,13,0,404,3.535
83,117,143,0,48,14,0,405,3.54
83,117,144,0,48,14,0,406,3.545
84,118,144,0,48,15,0,409,3.55
86,119,144,0,49,12,0,410,3.555
88,120,144,0,49,10,0,411,3.56
88,121,144,0,49,11,0,413,3.565
90,121,146,0,49,7,0,413,3.57
91,122,146,0,49,6,0,414,3.575
91,122,146,0,49,7,0,415,3.58
91,122,146,0,49,7,0,415,3.585
92,123,147,0,49,6,0,417,3.59
93,123,148,0,49,11,0,424,3.595
93,124,152,0,49,8,0,426,3.6
93,125,152,0,49,10,0,429,3.605
94,125,153,0,49,10,0,431,3.61
94,127,155,0,49,9,0,434,3.615
94,127,156,0,49,10,0,436,3.62
94,128,156,0,49,11,0,438,3.625
96,129,156,0,49,9,0,439,3.63
96,129,156,0,49,10,0,440,3.635
96,129,156,0,49,12,0,442,3.64
96,130,156,0,49,12,0,443,3.645
96,131,156,0,51,10,0,444,3.65
96,132,156,0,52,11,0,447,3.655
96,133,158,0,52,10,0,449,3.66
96,133,159,0,52,9,0,449,3.665
96,135,160,0,52,8,0,451,3.67
96,135,163,0,52,5,0,451,3.675
96,136,163,0,52,9,0,456,3.68
97,137,163,0,52,10,0,459,3.685
97,137,163,0,52,12,0,461,3.69
97,138,167,0,55,10,0,467,3.695
97,138,167,0,55,13,0,470,3.7
99,139,167,0,56,11,0,472,3.705
99,140,168,0,56,9,0,472,3.71
100,141,168,0,56,8,0,473,3.715
100,142,171,0,56,5,0,474,3.72
102,144,171,0,56,5,0,478,3.725
103,144,171,0,56,8,0,482,3.73
103,146,172,0,57,8,0,486,3.735
103,147,173,0,57,8,0,488,3.74
104,147,174,0,57,12,0,494,3.745
104,148,175,0,58,11,0,496,3.75
104,149,177,0,58,11,0,499,3.755
104,149,178,0,58,12,0,501,3.76
105,150,180,0,59,11,0,505,3.765
105,150,181,0,61,15,0,512,3.77
105,152,184,0,61,13,0,515,3.775
105,152,186,0,62,13,0,518,3.78
106,154,186,0,63,9,0,518,3.785
106,154,188,0,63,10,0,521,3.79
106,154,189,0,63,11,0,523,3.795
107,154,191,0,63,10,0,525,3.8
107,155,191,0,63,13,0,529,3.805
107,155,191,0,63,15,0,531,3.81
108,155,192,0,63,16,0,534,3.815
110,155,193,0,63,15,0,536,3.82
111,155,193,0,63,18,0,540,3.825
113,155,194,0,64,18,0,544,3.83
113,155,198,0,64,19,0,549,3.835
114,156,198,0,64,21,0,553,3.84
114,156,200,0,64,21,0,555,3.845
117,157,201,0,64,18,0,557,3.85
117,157,201,0,65,19,0,559,3.855
118,157,201,0,66,21,0,563,3.86
119,158,202,0,66,21,0,566,3.865
120,158,204,0,66,19,0,567,3.87
121,158,205,0,66,22,0,572,3.875
121,159,206,0,66,23,0,575,3.88
122,159,207,0,66,25,0,579,3.885
125,159,207,0,68,23,0,582,3.89
126,159,208,0,68,25,0,586,3.895
127,159,210,0,69,26,0,591,3.9
131,159,215,0,69,21,0,595,3.905
132,159,219,0,69,20,0,599,3.91
132,160,219,0,69,24,0,604,3.915
134,160,219,0,69,27,0,609,3.92
61,81,107,0,35,12,0,296,3.925
62,81,108,0,35,16,0,302,3.93
62,81,109,0,35,16,0,303,3.935
62,81,110,0,35,15,0,303,3.94
62,81,110,0,36,15,0,304,3.945
62,81,111,0,37,16,0,307,3.95
62,81,113,0,37,14,0,307,3.955
62,81,113,0,37,14,0,307,3.96
63,81,113,0,37,16,0,310,3.965
65,81,113,0,37,14,0,310,3.97
66,81,114,0,37,13,0,311,3.975
67,81,115,0,38,10,0,311,3.98
70,81,116,0,38,7,0,312,3.985
70,81,116,0,39,6,0,312,3.99
70,81,116,0,39,9,0,315,3.995
70,81,117,0,40,7,0,315,4
70,83,118,0,40,9,0,320,4.005
71,84,118,0,40,9,0,322,4.01
73,84,120,0,40,7,0,324,4.015
73,86,121,0,40,7,0,327,4.02
74,86,122,0,40,6,0,328,4.025
75,87,125,0,40,2,0,329,4.03
75,87,126,0,40,3,0,331,4.035
75,87,126,0,40,5,0,333,4.04
75,88,128,0,40,3,0,334,4.045
75,88,129,0,40,4,0,336,4.05
75,88,131,0,40,3,0,337,4.055
75,88,131,0,40,6,0,340,4.06
75,88,132,0,40,7,0,342,4.065
76,88,132,0,40,6,0,342,4.07
76,88,132,0,40,7,0,343,4.075
79,88,133,0,40,4,0,344,4.08
79,88,133,0,40,5,0,345,4.085
80,90,133,0,40,4,0,347,4.09
80,90,133,0,40,5,0,348,4.095
80,90,133,0,40,5,0,348,4.1
81,91,133,0,42,1,0,348,4.105
82,91,133,0,42,3,0,351,4.11
83,91,133,0,42,3,0,352,4.115
83,92,133,0,43,4,0,355,4.12
83,92,133,0,43,6,0,357,4.125
83,92,135,0,43,6,0,359,4.13
84,92,135,0,45,3,0,359,4.135
84,92,135,0,45,4,0,360,4.14
84,92,135,0,45,8,0,364,4.145
84,92,136,0,45,8,0,365,4.15
84,93,136,0,45,9,0,367,4.155
84,94,138,0,45,7,0,368,4.16
84,94,138,0,45,8,0,369,4.165
84,94,139,0,45,11,0,373,4.17
84,94,140,0,45,11,0,374,4.175
84,94,140,0,45,11,0,374,4.18
85,94,140,0,45,12,0,376,4.185
85,95,141,0,45,10,0,376,4.19
86,95,144,0,45,6,0,376,4.195
88,95,146,0,45,6,0,380,4.2
89,95,147,0,45,5,0,381,4.205
89,95,149,0,45,4,0,382,4.21
89,97,150,0,45,2,0,383,4.215
89,97,151,0,45,3,0,385,4.22
89,97,151,0,46,2,0,385,4.225
89,97,153,0,46,2,0,387,4.23
89,97,154,0,47,2,0,389,4.235
89,97,154,0,47,4,0,391,4.24
89,97,155,0,47,4,0,392,4.245
89,97,156,0,47,6,0,395,4.25
89,97,156,0,47,6,0,395,4.255
89,98,157,0,47,5,0,396,4.26
89,99,157,0,47,4,0,396,4.265
89,99,158,0,47,5,0,398,4.27
89,100,158,0,47,6,0,400,4.275
89,102,159,0,47,6,0,403,4.28
89,103,159,0,47,7,0,405,4.285
89,104,159,0,48,5,0,405,4.29
89,104,159,0,48,6,0,406,4.295
91,104,159,0,48,6,0,408,4.3
93,105,159,0,48,4,0,409,4.305
93,106,160,0,48,3,0,410,4.31
93,106,160,0,48,4,0,411,4.315
93,107,161,0,49,2,0,412,4.32
93,108,161,0,49,2,0,413,4.325
93,108,163,0,49,2,0,415,4.33
93,110,164,0,49,1,0,417,4.335
93,111,164,0,49,2,0,419,4.34
93,111,165,0,49,1,0,419,4.345
93,111,166,0,49,6,0,425,4.35
93,111,167,0,50,6,0,427,4.355
93,111,169,0,50,4,0,427,4.36
95,111,170,0,50,4,0,430,4.365
95,111,170,0,51,5,0,432,4.37
95,113,172,0,51,2,0,433,4.375
96,113,174,0,51,2,0,436,4.38
96,113,174,0,51,3,0,437,4.385
96,113,174,0,51,7,0,441,4.39
97,114,175,0,51,8,0,445,4.395
98,116,177,0,51,4,0,446,4.4
99,117,177,0,51,8,0,452,4.405
100,118,178,0,51,6,0,453,4.41
100,119,179,0,52,3,0,453,4.415
100,121,179,0,53,1,0,454,4.42
101,121,180,0,53,2,0,457,4.425
101,121,180,0,53,2,0,457,4.43
101,122,180,0,53,4,0,460,4.435
101,122,181,0,53,6,0,463,4.44
101,123,182,0,53,4,0,463,4.445
101,123,183,0,53,6,0,466,4.45
101,124,184,0,53,6,0,468,4.455
101,124,184,0,53,8,0,470,4.46
101,124,186,0,54,9,0,474,4.465
101,126,189,0,54,4,0,474,4.47
101,128,189,0,54,3,0,475,4.475
101,128,190,0,54,3,0,476,4.48
101,128,192,0,54,6,0,481,4.485
101,129,193,0,54,4,0,481,4.49
101,129,193,0,54,5,0,482,4.495
101,129,194,0,55,7,0,486,4.5
101,129,194,0,56,7,0,487,4.505
101,130,195,0,56,10,0,492,4.51
102,130,196,0,57,10,0,495,4.515
102,130,197,0,57,12,0,498,4.52
102,130,197,0,57,12,0,498,4.525
103,131,199,0,57,13,0,503,4.53
105,131,200,0,57,10,0,503,4.535
105,131,201,0,57,13,0,507,4.54
105,131,204,0,57,12,0,509,4.545
105,131,204,0,58,16,0,514,4.55
105,131,205,0,59,15,0,515,4.555
105,131,205,0,59,16,0,516,4.56
105,131,206,0,59,16,0,517,4.565
106,132,206,0,59,16,0,519,4.57
106,133,207,0,59,17,0,522,4.575
106,133,211,0,59,17,0,526,4.58
106,135,212,0,59,19,0,531,4.585
107,135,214,0,61,17,0,534,4.59
107,135,218,0,61,16,0,537,4.595
107,136,220,0,61,15,0,539,4.6
107,136,220,0,61,18,0,542,4.605
107,138,221,0,61,17,0,544,4.61
108,141,223,0,61,12,0,545,4.615
109,142,225,0,61,12,0,549,4.62
109,143,225,0,61,13,0,551,4.625
109,144,225,0,61,14,0,553,4.63
109,144,226,0,61,17,0,557,4.635
110,145,228,0,61,16,0,560,4.64
110,146,229,0,61,16,0,562,4.645
114,146,230,0,61,13,0,564,4.65
115,147,230,0,62,13,0,567,4.655
115,147,232,0,63,13,0,570,4.66
115,148,233,0,63,14,0,573,4.665
115,149,236,0,63,13,0,576,4.67
115,149,236,0,63,17,0,580,4.675
116,150,237,0,64,15,0,582,4.68
118,151,237,0,64,14,0,584,4.685
118,151,239,0,64,14,0,586,4.69
119,151,241,0,64,12,0,587,4.695
120,152,243,0,64,11,0,590,4.7
120,153,245,0,64,10,0,592,4.705
120,154,248,0,64,8,0,594,4.71
120,154,250,0,64,8,0,596,4.715
121,154,252,0,64,9,0,600,4.72
122,156,253,0,64,5,0,600,4.725
122,156,253,0,64,5,0,600,4.73
123,157,256,0,65,0,0,601,4.735
123,158,256,0,65,3,0,605,4.74
123,158,257,0,65,4,0,607,4.745
123,158,257,0,65,9,0,612,4.75
123,158,257,0,65,14,0,617,4.755
124,158,257,0,66,16,0,621,4.76
124,158,258,0,67,17,0,624,4.765
124,159,259,0,67,18,0,627,4.77
126,159,261,0,67,16,0,629,4.775
126,159,264,0,67,17,0,633,4.78
127,159,266,0,67,17,0,636,4.785
127,160,266,0,68,16,0,637,4.79
127,160,268,0,68,17,0,640,4.795
127,160,270,0,68,18,0,643,4.8
129,160,271,0,68,17,0,645,4.805
129,160,273,0,68,20,0,650,4.81
129,161,273,0,68,22,0,653,4.815
129,161,273,0,68,26,0,657,4.82
129,161,274,0,68,27,0,659,4.825
130,161,275,0,68,29,0,663,4.83
70,85,160,0,36,13,0,364,4.835
70,85,161,0,36,14,0,366,4.84
70,85,161,0,37,13,0,366,4.845
70,86,162,0,37,12,0,367,4.85
71,86,162,0,37,13,0,369,4.855
71,86,162,0,37,13,0,369,4.86
71,86,162,0,38,12,0,369,4.865
71,86,163,0,38,13,0,371,4.87
72,86,163,0,38,14,0,373,4.875
73,86,163,0,38,13,0,373,4.88
74,86,164,0,38,11,0,373,4.885
74,86,165,0,38,13,0,376,4.89
74,87,166,0,38,11,0,376,4.895
75,87,167,0,39,8,0,376,4.9
76,88,167,0,39,8,0,378,4.905
76,89,169,0,39,10,0,383,4.91
76,90,170,0,39,9,0,384,4.915
76,91,171,0,40,7,0,385,4.92
78,91,173,0,40,4,0,386,4.925
78,91,174,0,40,6,0,389,4.93
79,91,175,0,40,4,0,389,4.935
79,91,177,0,41,1,0,389,4.94
79,92,177,0,41,1,0,390,4.945
79,92,178,0,41,0,0,390,4.95
79,92,178,0,41,1,0,391,4.955
79,92,179,0,41,1,0,392,4.96
79,92,179,0,41,2,0,393,4.965
79,92,180,0,41,3,0,395,4.97
79,93,180,0,41,4,0,397,4.975
79,93,180,0,41,7,0,400,4.98
79,93,181,0,41,7,0,401,4.985
79,95,182,0,41,4,0,401,4.99
81,96,183,0,41,2,0,403,4.995
81,97,184,0,42,2,0,406,5
81,97,185,0,42,4,0,409,5.005
81,97,185,0,42,6,0,411,5.01
81,98,187,0,42,6,0,414,5.015
81,100,191,0,42,3,0,417,5.02
81,102,192,0,42,3,0,420,5.025
81,103,192,0,42,3,0,421,5.03
81,103,192,0,42,6,0,424,5.035
81,103,193,0,42,8,0,427,5.04
81,104,194,0,42,6,0,427,5.045
81,104,194,0,42,8,0,429,5.05
81,104,194,0,42,11,0,432,5.055
82,104,197,0,42,11,0,436,5.06
83,104,199,0,42,12,0,440,5.065
84,105,201,0,42,10,0,442,5.07
84,105,201,0,42,11,0,443,5.075
84,105,201,0,42,13,0,445,5.08
84,105,201,0,42,14,0,446,5.085
85,106,201,0,42,14,0,448,5.09
85,106,202,0,42,13,0,448,5.095
86,107,202,0,43,10,0,448,5.1
86,108,202,0,43,11,0,450,5.105
86,108,202,0,43,12,0,451,5.11
86,108,203,0,43,12,0,452,5.115
86,110,207,0,44,6,0,453,5.12
86,110,208,0,44,8,0,456,5.125
87,110,208,0,44,9,0,458,5.13
87,111,209,0,45,9,0,461,5.135
87,111,209,0,46,10,0,463,5.14
87,113,211,0,47,7,0,465,5.145
89,113,212,0,47,6,0,467,5.15
90,113,213,0,47,6,0,469,5.155
91,113,213,0,48,7,0,472,5.16
91,113,213,0,49,8,0,474,5.165
91,114,214,0,49,8,0,476,5.17
92,115,214,0,49,12,0,482,5.175
93,117,215,0,49,15,0,489,5.18
96,118,215,0,49,12,0,490,5.185
98,118,217,0,49,10,0,492,5.19
99,118,217,0,49,10,0,493,5.195
99,121,218,0,49,10,0,497,5.2
99,121,219,0,49,11,0,499,5.205
99,122,219,0,49,12,0,501,5.21
99,123,221,0,49,11,0,503,5.215
101,126,221,0,49,8,0,505,5.22
101,126,222,0,49,9,0,507,5.225
102,126,222,0,49,11,0,510,5.23
102,127,222,0,49,13,0,513,5.235
103,127,224,0,49,11,0,514,5.24
103,127,226,0,49,11,0,516,5.245
104,127,227,0,50,9,0,517,5.25
104,128,227,0,50,10,0,519,5.255
104,128,230,0,50,8,0,520,5.26
104,129,231,0,50,9,0,523,5.265
104,130,233,0,50,8,0,525,5.27
104,130,234,0,50,11,0,529,5.275
105,130,237,0,50,9,0,531,5.28
105,132,238,0,50,7,0,532,5.285
105,133,238,0,50,8,0,534,5.29
106,133,239,0,51,6,0,535,5.295
107,133,239,0,51,6,0,536,5.3
107,133,239,0,52,5,0,536,5.305
107,134,240,0,52,8,0,541,5.31
107,136,241,0,52,8,0,544,5.315
107,136,241,0,52,12,0,548,5.32
107,136,242,0,52,11,0,548,5.325
108,137,243,0,53,9,0,550,5.33
108,137,243,0,53,11,0,552,5.335
108,137,245,0,53,10,0,553,5.34
108,138,246,0,54,9,0,555,5.345
108,141,247,0,54,8,0,558,5.35
109,142,247,0,54,7,0,559,5.355
109,143,249,0,54,8,0,563,5.36
109,143,250,0,54,10,0,566,5.365
110,144,251,0,54,9,0,568,5.37
110,146,251,0,54,8,0,569,5.375
110,148,252,0,54,8,0,572,5.38
110,150,253,0,54,5,0,572,5.385
110,151,255,0,54,4,0,574,5.39
110,151,256,0,54,9,0,580,5.395
110,152,257,0,54,8,0,581,5.4
111,152,258,0,54,7,0,582,5.405
111,153,259,0,54,10,0,587,5.41
111,153,261,0,55,10,0,590,5.415
113,155,261,0,56,10,0,595,5.42
114,156,264,0,56,7,0,597,5.425
114,157,265,0,56,9,0,601,5.43
114,157,266,0,56,11,0,604,5.435
114,157,266,0,57,12,0,606,5.44
114,158,267,0,57,13,0,609,5.445
114,159,268,0,58,12,0,611,5.45
114,160,268,0,58,15,0,615,5.455
114,162,270,0,58,13,0,617,5.46
114,162,271,0,58,15,0,620,5.465
115,162,273,0,58,16,0,624,5.47
115,163,276,0,58,14,0,626,5.475
116,164,278,0,58,10,0,626,5.48
118,164,278,0,58,16,0,634,5.485
119,164,278,0,60,17,0,638,5.49
119,164,279,0,60,20,0,642,5.495
120,165,280,0,60,22,0,647,5.5
120,165,281,0,60,22,0,648,5.505
120,166,281,0,60,24,0,651,5.51
120,166,281,0,60,26,0,653,5.515
120,166,282,0,61,25,0,654,5.52
121,167,283,0,61,25,0,657,5.525
122,167,284,0,61,24,0,658,5.53
122,167,286,0,61,24,0,660,5.535
122,169,287,0,61,24,0,663,5.54
123,170,288,0,61,27,0,669,5.545
124,170,290,0,61,26,0,671,5.55
126,171,291,0,61,25,0,674,5.555
128,171,292,0,62,24,0,677,5.56
129,171,293,0,62,25,0,680,5.565
132,171,294,0,64,22,0,683,5.57
134,171,296,0,64,22,0,687,5.575
135,173,296,0,64,22,0,690,5.58
135,173,297,0,64,27,0,696,5.585
136,174,297,0,64,28,0,699,5.59
137,175,297,0,64,29,0,702,5.595
139,175,298,0,65,27,0,704,5.6
139,176,298,0,66,28,0,707,5.605
139,176,299,0,66,29,0,709,5.61
141,176,301,0,66,28,0,712,5.615
141,176,302,0,67,30,0,716,5.62
141,176,303,0,69,29,0,718,5.625
83,89,136,0,40,15,0,363,5.63
83,89,137,0,41,13,0,363,5.635
84,90,138,0,41,12,0,365,5.64
86,90,138,0,41,12,0,367,5.645
86,91,138,0,41,13,0,369,5.65
87,91,138,0,41,12,0,369,5.655
88,91,139,0,41,11,0,370,5.66
88,92,143,0,41,6,0,370,5.665
88,93,145,0,41,4,0,371,5.67
88,93,145,0,41,5,0,372,5.675
89,93,145,0,41,5,0,373,5.68
89,93,145,0,42,7,0,376,5.685
90,94,145,0,42,5,0,376,5.69
90,95,146,0,42,4,0,377,5.695
90,97,146,0,42,2,0,377,5.7
90,97,146,0,42,5,0,380,5.705
90,97,146,0,42,5,0,380,5.71
91,98,147,0,42,4,0,382,5.715
91,98,149,0,43,4,0,385,5.72
91,98,149,0,43,6,0,387,5.725
91,101,150,0,43,4,0,389,5.73
91,102,150,0,43,5,0,391,5.735
91,102,151,0,44,7,0,395,5.74
91,102,153,0,45,7,0,398,5.745
92,103,153,0,45,6,0,399,5.75
92,104,156,0,45,4,0,401,5.755
92,104,158,0,45,5,0,404,5.76
92,106,159,0,45,3,0,405,5.765
92,107,160,0,45,4,0,408,5.77
93,108,160,0,45,3,0,409,5.775
93,110,161,0,45,3,0,412,5.78
94,111,161,0,45,2,0,413,5.785
94,111,162,0,45,2,0,414,5.79
94,111,162,0,46,4,0,417,5.795
95,113,162,0,47,0,0,417,5.8
95,113,162,0,47,2,0,419,5.805
95,113,163,0,47,3,0,421,5.81
95,113,164,0,47,3,0,422,5.815
96,114,165,0,47,1,0,423,5.82
96,114,165,0,47,1,0,423,5.825
96,114,165,0,47,2,0,424,5.83
96,114,165,0,47,2,0,424,5.835
96,114,165,0,47,3,0,425,5.84
96,114,167,0,47,2,0,426,5.845
96,115,167,0,47,2,0,427,5.85
96,116,167,0,47,4,0,430,5.855
96,116,167,0,47,6,0,432,5.86
96,117,167,0,48,5,0,433,5.865
96,119,167,0,48,6,0,436,5.87
96,120,168,0,48,5,0,437,5.875
96,121,168,0,48,6,0,439,5.88
97,122,170,0,48,3,0,440,5.885
97,123,170,0,48,5,0,443,5.89
97,123,170,0,48,6,0,444,5.895
97,123,171,0,48,8,0,447,5.9
97,123,171,0,48,13,0,452,5.905
97,124,171,0,48,12,0,452,5.91
98,125,172,0,48,13,0,456,5.915
100,125,173,0,48,17,0,463,5.92
100,125,173,0,48,19,0,465,5.925
102,125,173,0,48,19,0,467,5.93
103,125,175,0,48,19,0,470,5.935
104,125,176,0,48,18,0,471,5.94
105,125,176,0,48,18,0,472,5.945
107,125,176,0,48,16,0,472,5.95
108,128,178,0,49,11,0,474,5.955
109,128,178,0,50,13,0,478,5.96
110,128,179,0,50,11,0,478,5.965
111,131,180,0,50,9,0,481,5.97
111,132,181,0,50,7,0,481,5.975
111,132,181,0,50,9,0,483,5.98
111,132,182,0,51,8,0,484,5.985
111,132,182,0,51,12,0,488,5.99
111,132,182,0,51,19,0,495,5.995
112,133,185,0,51,17,0,498,6
113,133,190,0,51,13,0,500,6.005
115,133,191,0,51,17,0,507,6.01
117,133,192,0,52,14,0,508,6.015
117,134,194,0,52,16,0,513,6.02
118,134,194,0,52,15,0,513,6.025
118,135,194,0,52,16,0,515,6.03
118,135,197,0,52,16,0,518,6.035
118,135,197,0,53,17,0,520,6.04
118,136,201,0,55,12,0,522,6.045
118,139,202,0,55,12,0,526,6.05
118,140,203,0,55,13,0,529,6.055
118,141,204,0,56,13,0,532,6.06
118,142,204,0,56,14,0,534,6.065
119,143,205,0,56,14,0,537,6.07
119,143,206,0,56,16,0,540,6.075
121,143,207,0,56,16,0,543,6.08
123,143,208,0,57,15,0,546,6.085
124,144,209,0,57,17,0,551,6.09
125,145,210,0,57,18,0,555,6.095
126,145,211,0,57,18,0,557,6.1
130,146,212,0,57,14,0,559,6.105
130,148,213,0,58,13,0,562,6.11
131,149,213,0,58,12,0,563,6.115
131,149,215,0,58,14,0,567,6.12
132,151,216,0,58,12,0,569,6.125
132,151,217,0,58,13,0,571,6.13
132,154,219,0,58,9,0,572,6.135
134,158,219,0,58,5,0,574,6.14
134,158,219,0,58,9,0,578,6.145
136,158,219,0,59,6,0,578,6.15
138,159,221,0,60,5,0,583,6.155
138,159,222,0,60,7,0,586,6.16
138,159,223,0,60,12,0,592,6.165
138,159,223,0,60,16,0,596,6.17
140,160,223,0,60,14,0,597,6.175
141,160,225,0,60,16,0,602,6.18
141,161,225,0,60,19,0,606,6.185
142,161,226,0,60,20,0,609,6.19
144,161,228,0,60,20,0,613,6.195
144,164,232,0,60,19,0,619,6.2
145,164,234,0,60,21,0,624,6.205
145,164,236,0,61,19,0,625,6.21
148,164,240,0,61,14,0,627,6.215
151,164,241,0,62,10,0,628,6.22
151,164,241,0,64,9,0,629,6.225
151,165,242,0,64,9,0,631,6.23
152,167,243,0,64,9,0,635,6.235
152,167,244,0,64,9,0,636,6.24
152,169,246,0,64,9,0,640,6.245
154,170,247,0,64,9,0,644,6.25
154,174,249,0,64,9,0,650,6.255
154,175,251,0,64,10,0,654,6.26
154,175,253,0,65,9,0,656,6.265
154,178,254,0,65,6,0,657,6.27
154,182,255,0,65,6,0,662,6.275
155,182,256,0,65,6,0,664,6.28
155,184,258,0,65,6,0,668,6.285
155,184,258,0,65,8,0,670,6.29
155,184,262,0,65,5,0,671,6.295
155,184,263,0,65,6,0,673,6.3
155,184,263,0,65,13,0,680,6.305
155,185,266,0,65,15,0,686,6.31
156,186,266,0,65,18,0,691,6.315
156,187,266,0,67,18,0,694,6.32
156,188,268,0,67,18,0,697,6.325
157,188,268,0,67,20,0,700,6.33
158,188,269,0,69,18,0,702,6.335
159,189,272,0,69,17,0,706,6.34
160,190,272,0,69,19,0,710,6.345
161,190,273,0,69,19,0,712,6.35
163,191,275,0,69,17,0,715,6.355
163,192,276,0,69,19,0,719,6.36
164,194,280,0,69,15,0,722,6.365
165,194,281,0,69,14,0,723,6.37
85,104,141,0,33,7,0,370,6.375
85,104,144,0,33,7,0,373,6.38
85,105,144,0,33,9,0,376,6.385
86,107,145,0,33,8,0,379,6.39
86,108,145,0,33,9,0,381,6.395
86,108,145,0,34,10,0,383,6.4
86,109,148,0,34,9,0,386,6.405
88,110,148,0,34,10,0,390,6.41
88,111,149,0,34,9,0,391,6.415
89,111,149,0,34,9,0,392,6.42
89,111,151,0,34,8,0,393,6.425
89,112,152,0,34,10,0,397,6.43
90,112,153,0,34,11,0,400,6.435
93,113,153,0,34,10,0,403,6.44
94,113,153,0,34,10,0,404,6.445
96,114,154,0,34,10,0,408,6.45
97,114,154,0,34,14,0,413,6.455
98,114,154,0,34,14,0,414,6.46
99,115,155,0,34,14,0,417,6.465
100,115,156,0,34,15,0,420,6.47
102,115,157,0,35,11,0,420,6.475
103,115,159,0,35,10,0,422,6.48
104,115,162,0,35,7,0,423,6.485
104,115,163,0,35,7,0,424,6.49
104,116,163,0,35,6,0,424,6.495
105,116,164,0,35,6,0,426,6.5
106,116,165,0,35,7,0,429,6.505
106,116,165,0,36,9,0,432,6.51
107,116,168,0,36,8,0,435,6.515
107,116,169,0,36,11,0,439,6.52
107,116,170,0,37,9,0,439,6.525
108,116,171,0,37,13,0,445,6.53
109,117,171,0,38,11,0,446,6.535
109,118,174,0,38,10,0,449,6.54
109,120,174,0,38,9,0,450,6.545
110,121,175,0,38,6,0,450,6.55
110,122,177,0,38,7,0,454,6.555
110,123,178,0,38,7,0,456,6.56
111,124,178,0,38,9,0,460,6.565
111,124,179,0,38,11,0,463,6.57
114,126,179,0,38,7,0,464,6.575
114,126,182,0,38,8,0,468,6.58
114,126,183,0,39,9,0,471,6.585
115,128,184,0,39,8,0,474,6.59
115,128,186,0,39,6,0,474,6.595
115,129,189,0,39,4,0,476,6.6
115,132,190,0,39,4,0,480,6.605
115,134,191,0,39,4,0,483,6.61
115,135,191,0,39,4,0,484,6.615
116,136,191,0,40,5,0,488,6.62
116,139,191,0,40,2,0,488,6.625
116,139,192,0,40,2,0,489,6.63
116,139,192,0,40,2,0,489,6.635
117,139,194,0,40,1,0,491,6.64
117,139,194,0,40,3,0,493,6.645
117,139,196,0,40,5,0,497,6.65
117,140,196,0,40,7,0,500,6.655
117,143,197,0,40,4,0,501,6.66
117,143,197,0,40,6,0,503,6.665
117,145,199,0,40,4,0,505,6.67
117,146,200,0,40,3,0,506,6.675
117,146,202,0,40,2,0,507,6.68
117,146,202,0,40,8,0,513,6.685
117,147,202,0,41,7,0,514,6.69
117,148,203,0,41,8,0,517,6.695
117,150,204,0,42,7,0,520,6.7
118,150,206,0,42,7,0,523,6.705
118,150,208,0,42,6,0,524,6.71
119,151,208,0,43,5,0,526,6.715
119,151,209,0,43,6,0,528,6.72
119,152,211,0,44,5,0,531,6.725
119,154,211,0,44,5,0,533,6.73
119,155,212,0,45,4,0,535,6.735
119,156,213,0,45,5,0,538,6.74
120,157,214,0,45,6,0,542,6.745
121,157,215,0,46,7,0,546,6.75
122,159,216,0,46,6,0,549,6.755
124,159,219,0,46,4,0,552,6.76
126,159,220,0,46,7,0,558,6.765
126,160,220,0,46,7,0,559,6.77
126,162,222,0,46,10,0,566,6.775
127,163,223,0,46,8,0,567,6.78
128,166,225,0,46,5,0,570,6.785
128,168,226,0,46,5,0,573,6.79
129,169,226,0,46,6,0,576,6.795
129,169,226,0,46,8,0,578,6.8
129,171,226,0,46,10,0,582,6.805
130,171,228,0,46,10,0,585,6.81
131,172,232,0,47,5,0,587,6.815
131,172,233,0,48,8,0,592,6.82
131,174,235,0,48,7,0,595,6.825
132,174,236,0,48,8,0,598,6.83
132,175,237,0,48,9,0,601,6.835
132,176,240,0,48,10,0,606,6.84
132,176,241,0,48,13,0,610,6.845
133,178,242,0,48,12,0,613,6.85
136,178,242,0,48,13,0,617,6.855
137,180,242,0,50,10,0,619,6.86
139,183,242,0,51,4,0,619,6.865
139,184,243,0,51,6,0,623,6.87
139,186,244,0,51,6,0,626,6.875
139,186,244,0,51,9,0,629,6.88
139,188,244,0,51,7,0,629,6.885
139,188,245,0,51,7,0,630,6.89
140,190,245,0,51,5,0,631,6.895
142,191,246,0,52,3,0,634,6.9
142,191,247,0,53,5,0,638,6.905
142,191,248,0,53,8,0,642,6.91
143,191,248,0,53,8,0,643,6.915
143,193,249,0,53,7,0,645,6.92
143,193,250,0,53,9,0,648,6.925
143,193,250,0,53,14,0,653,6.93
144,197,254,0,56,3,0,654,6.935
144,199,255,0,56,4,0,658,6.94
144,201,257,0,56,6,0,664,6.945
145,201,258,0,56,7,0,667,6.95
145,202,262,0,56,7,0,672,6.955
145,205,263,0,56,3,0,672,6.96
146,205,263,0,56,7,0,677,6.965
146,207,264,0,56,8,0,681,6.97
146,208,264,0,56,8,0,682,6.975
146,208,265,0,56,11,0,686,6.98
146,209,266,0,56,14,0,691,6.985
147,212,268,0,56,13,0,696,6.99
148,213,270,0,56,13,0,700,6.995
150,213,271,0,56,12,0,702,7
150,213,272,0,56,14,0,705,7.005
152,214,273,0,56,16,0,711,7.01
153,215,275,0,56,14,0,713,7.015
154,215,275,0,56,17,0,717,7.02
157,215,278,0,56,19,0,725,7.025
157,215,278,0,56,23,0,729,7.03
157,216,279,0,56,24,0,732,7.035
159,216,280,0,57,22,0,734,7.04
160,216,281,0,59,22,0,738,7.045
161,218,282,0,59,19,0,739,7.05
162,218,284,0,59,20,0,743,7.055
163,218,285,0,60,20,0,746,7.06
166,219,287,0,60,19,0,751,7.065
167,221,287,0,61,22,0,758,7.07
169,222,289,0,61,21,0,762,7.075
169,223,293,0,61,18,0,764,7.08
171,223,294,0,61,20,0,769,7.085
173,223,294,0,61,21,0,772,7.09
175,224,297,0,61,20,0,777,7.095
175,226,301,0,61,16,0,779,7.1
175,227,305,0,61,14,0,782,7.105
175,229,310,0,62,8,0,784,7.11
177,229,310,0,62,13,0,791,7.115
177,229,311,0,64,14,0,795,7.12
179,229,313,0,65,17,0,803,7.125
180,230,315,0,65,20,0,810,7.13
183,232,318,0,65,16,0,814,7.135
185,234,319,0,65,13,0,816,7.14
186,236,320,0,65,13,0,820,7.145
186,236,324,0,65,13,0,824,7.15
186,236,324,0,68,14,0,828,7.155
187,236,326,0,69,14,0,832,7.16
187,239,327,0,69,16,0,838,7.165
187,240,333,0,69,13,0,842,7.17
187,244,337,0,69,11,0,848,7.175
187,246,338,0,69,9,0,849,7.18
187,247,340,0,69,9,0,852,7.185
187,249,341,0,69,11,0,857,7.19
187,251,342,0,69,10,0,859,7.195
102,129,177,0,34,5,0,447,7.2
103,131,180,0,34,0,0,448,7.205
103,131,181,0,34,1,0,450,7.21
103,131,181,0,34,3,0,452,7.215
103,132,183,0,34,3,0,455,7.22
103,132,183,0,34,3,0,455,7.225
103,132,183,0,34,4,0,456,7.23
104,132,183,0,35,7,0,461,7.235
105,132,184,0,35,7,0,463,7.24
105,132,184,0,36,8,0,465,7.245
107,132,187,0,36,7,0,469,7.25
107,135,188,0,36,3,0,469,7.255
108,135,188,0,36,4,0,471,7.26
109,135,188,0,36,7,0,475,7.265
109,135,188,0,36,8,0,476,7.27
109,136,190,0,37,6,0,478,7.275
109,136,192,0,37,5,0,479,7.28
109,138,193,0,38,2,0,480,7.285
109,139,193,0,38,5,0,484,7.29
109,141,193,0,38,4,0,485,7.295
109,141,195,0,38,5,0,488,7.3
109,142,196,0,39,10,0,496,7.305
110,142,197,0,39,8,0,496,7.31
110,144,197,0,39,9,0,499,7.315
112,146,198,0,39,6,0,501,7.32
112,147,198,0,39,11,0,507,7.325
112,148,198,0,39,11,0,508,7.33
112,149,198,0,39,14,0,512,7.335
112,149,201,0,39,15,0,516,7.34
113,149,203,0,40,13,0,518,7.345
113,151,203,0,42,11,0,520,7.35
115,152,204,0,42,10,0,523,7.355
115,153,207,0,42,10,0,527,7.36
116,153,207,0,42,14,0,532,7.365
116,153,208,0,43,15,0,535,7.37
116,154,208,0,44,18,0,540,7.375
117,154,211,0,44,15,0,541,7.38
119,154,212,0,44,15,0,544,7.385
120,154,212,0,44,15,0,545,7.39
120,154,212,0,44,17,0,547,7.395
123,154,214,0,44,16,0,551,7.4
125,154,216,0,44,13,0,552,7.405
125,154,217,0,44,16,0,556,7.41
127,154,218,0,44,14,0,557,7.415
127,154,219,0,44,14,0,558,7.42
127,155,219,0,44,16,0,561,7.425
128,155,220,0,44,17,0,564,7.43
128,157,220,0,45,16,0,566,7.435
128,157,220,0,45,19,0,569,7.44
130,157,221,0,45,17,0,570,7.445
130,159,222,0,46,20,0,577,7.45
132,159,226,0,46,16,0,579,7.455
133,159,226,0,46,19,0,583,7.46
133,159,226,0,47,21,0,586,7.465
133,159,226,0,47,23,0,588,7.47
135,159,226,0,47,26,0,593,7.475
135,159,227,0,47,27,0,595,7.48
135,159,229,0,47,25,0,595,7.485
137,159,231,0,49,23,0,599,7.49
141,163,234,0,50,13,0,601,7.495
144,164,236,0,50,8,0,602,7.5
144,165,236,0,50,9,0,604,7.505
144,166,237,0,50,9,0,606,7.51
146,170,238,0,50,7,0,611,7.515
146,170,238,0,51,8,0,613,7.52
146,171,238,0,51,8,0,614,7.525
147,172,238,0,51,12,0,620,7.53
147,172,239,0,51,13,0,622,7.535
147,174,241,0,51,12,0,625,7.54
149,175,242,0,51,11,0,628,7.545
150,176,243,0,51,12,0,632,7.55
152,177,245,0,52,8,0,634,7.555
152,177,248,0,52,6,0,635,7.56
152,179,248,0,52,10,0,641,7.565
153,179,248,0,52,13,0,645,7.57
153,180,248,0,52,14,0,647,7.575
155,183,249,0,52,11,0,650,7.58
155,183,251,0,52,11,0,652,7.585
156,185,253,0,52,10,0,656,7.59
156,187,254,0,53,8,0,658,7.595
157,190,254,0,54,7,0,662,7.6
157,192,254,0,55,8,0,666,7.605
158,192,254,0,55,11,0,670,7.61
160,193,255,0,55,14,0,677,7.615
160,195,256,0,55,15,0,681,7.62
160,197,258,0,55,19,0,689,7.625
161,199,258,0,55,21,0,694,7.63
162,199,260,0,55,18,0,694,7.635
163,201,261,0,55,18,0,698,7.64
164,202,261,0,55,18,0,700,7.645
165,203,261,0,55,23,0,707,7.65
166,205,261,0,55,23,0,710,7.655
167,205,263,0,55,22,0,712,7.66
170,205,263,0,56,23,0,717,7.665
171,206,265,0,57,22,0,721,7.67
171,206,267,0,57,24,0,725,7.675
173,208,270,0,58,23,0,732,7.68
175,208,270,0,59,21,0,733,7.685
176,211,273,0,60,17,0,737,7.69
177,211,275,0,60,21,0,744,7.695
177,211,277,0,60,20,0,745,7.7
177,211,281,0,60,18,0,747,7.705
177,211,282,0,60,22,0,752,7.71
179,213,283,0,60,21,0,756,7.715
181,213,283,0,61,22,0,760,7.72
182,213,285,0,61,20,0,761,7.725
184,215,290,0,61,12,0,762,7.73
185,218,290,0,62,14,0,769,7.735
185,220,292,0,63,10,0,770,7.74
185,220,292,0,63,14,0,774,7.745
185,221,294,0,63,13,0,776,7.75
186,222,299,0,63,7,0,777,7.755
186,224,299,0,64,7,0,780,7.76
186,227,300,0,64,8,0,785,7.765
186,228,301,0,66,6,0,787,7.77
187,228,301,0,67,7,0,790,7.775
187,230,302,0,67,6,0,792,7.78
187,231,303,0,67,13,0,801,7.785
188,233,303,0,67,14,0,805,7.79
188,234,305,0,68,13,0,808,7.795
189,234,305,0,69,11,0,808,7.8
189,235,305,0,69,12,0,810,7.805
93,121,159,0,39,4,0,416,7.81
93,121,161,0,40,2,0,417,7.815
93,121,161,0,41,3,0,419,7.82
93,121,161,0,42,9,0,426,7.825
93,122,161,0,42,10,0,428,7.83
95,123,161,0,42,10,0,431,7.835
95,123,162,0,42,10,0,432,7.84
95,124,162,0,43,8,0,432,7.845
95,124,164,0,43,6,0,432,7.85
95,124,164,0,43,7,0,433,7.855
96,125,164,0,43,7,0,435,7.86
96,126,165,0,43,6,0,436,7.865
96,127,165,0,43,6,0,437,7.87
97,127,166,0,43,6,0,439,7.875
98,128,167,0,44,5,0,442,7.88
98,129,167,0,44,9,0,447,7.885
98,129,167,0,44,11,0,449,7.89
98,130,168,0,44,14,0,454,7.895
98,131,170,0,44,11,0,454,7.9
100,132,170,0,44,10,0,456,7.905
100,133,172,0,44,12,0,461,7.91
100,134,172,0,44,11,0,461,7.915
101,134,174,0,44,9,0,462,7.92
101,136,176,0,45,6,0,464,7.925
101,137,177,0,45,6,0,466,7.93
101,137,180,0,46,6,0,470,7.935
101,140,182,0,46,2,0,471,7.94
101,141,183,0,46,3,0,474,7.945
102,141,183,0,46,7,0,479,7.95
102,142,184,0,46,7,0,481,7.955
102,143,184,0,46,8,0,483,7.96
102,144,184,0,46,8,0,484,7.965
102,144,184,0,46,11,0,487,7.97
103,144,185,0,46,10,0,488,7.975
103,144,187,0,46,10,0,490,7.98
105,146,187,0,47,10,0,495,7.985
106,146,187,0,48,11,0,498,7.99
107,147,188,0,48,12,0,502,7.995
107,148,188,0,48,13,0,504,8
108,148,188,0,48,14,0,506,8.005
109,148,188,0,48,18,0,511,8.01
111,148,188,0,49,17,0,513,8.015
112,148,189,0,50,15,0,514,8.02
113,148,189,0,51,17,0,518,8.025
113,149,189,0,51,19,0,521,8.03
114,151,191,0,52,15,0,523,8.035
115,152,191,0,53,15,0,526,8.04
116,153,192,0,53,17,0,531,8.045
116,153,192,0,54,18,0,533,8.05
117,153,192,0,54,20,0,536,8.055
118,153,195,0,54,18,0,538,8.06
118,153,198,0,54,18,0,541,8.065
118,153,198,0,54,19,0,542,8.07
121,153,203,0,55,15,0,547,8.075
122,155,203,0,56,13,0,549,8.08
123,155,205,0,56,15,0,554,8.085
124,157,205,0,56,18,0,560,8.09
125,159,208,0,56,16,0,564,8.095
125,160,209,0,57,17,0,568,8.1
126,160,212,0,57,19,0,574,8.105
127,160,212,0,58,21,0,578,8.11
127,160,212,0,59,21,0,579,8.115
129,160,212,0,59,24,0,584,8.12
131,160,212,0,59,25,0,587,8.125
133,161,214,0,59,24,0,591,8.13
135,162,215,0,59,21,0,592,8.135
136,166,215,0,59,18,0,594,8.14
138,167,215,0,59,19,0,598,8.145
140,167,215,0,59,20,0,601,8.15
141,167,218,0,59,17,0,602,8.155
142,167,219,0,59,16,0,603,8.16
142,168,220,0,59,15,0,604,8.165
142,168,220,0,59,17,0,606,8.17
143,170,221,0,60,15,0,609,8.175
143,170,223,0,61,13,0,610,8.18
144,170,223,0,61,16,0,614,8.185
144,171,226,0,62,16,0,619,8.19
144,172,228,0,62,17,0,623,8.195
145,172,231,0,63,17,0,628,8.2
146,173,232,0,64,20,0,635,8.205
149,174,232,0,64,20,0,639,8.21
149,174,234,0,65,20,0,642,8.215
150,175,234,0,65,20,0,644,8.22
152,177,235,0,65,17,0,646,8.225
154,180,237,0,66,10,0,647,8.23
155,180,238,0,67,11,0,651,8.235
155,182,240,0,67,10,0,654,8.24
155,183,242,0,67,8,0,655,8.245
156,185,246,0,67,4,0,658,8.25
156,185,247,0,67,9,0,664,8.255
156,185,247,0,68,10,0,666,8.26
156,185,249,0,68,9,0,667,8.265
157,187,250,0,68,5,0,667,8.27
158,187,250,0,69,5,0,669,8.275
158,189,251,0,69,4,0,671,8.28
71,83,131,0,33,1,0,319,8.285
71,84,131,0,33,3,0,322,8.29
71,84,132,0,33,3,0,323,8.295
71,86,133,0,33,2,0,325,8.3
71,86,133,0,33,3,0,326,8.305
71,86,133,0,33,6,0,329,8.31
71,86,133,0,33,7,0,330,8.315
71,86,134,0,34,5,0,330,8.32
71,87,137,0,34,4,0,333,8.325
71,87,137,0,34,10,0,339,8.33
71,88,137,0,34,12,0,342,8.335
71,88,137,0,34,17,0,347,8.34
71,88,138,0,34,17,0,348,8.345
71,88,139,0,34,17,0,349,8.35
71,88,139,0,35,17,0,350,8.355
73,88,139,0,35,18,0,353,8.36
73,88,140,0,35,20,0,356,8.365
74,88,141,0,35,19,0,357,8.37
75,88,141,0,37,17,0,358,8.375
75,89,143,0,37,14,0,358,8.38
76,89,145,0,37,12,0,359,8.385
76,89,145,0,37,15,0,362,8.39
76,89,145,0,38,17,0,365,8.395
76,89,146,0,38,16,0,365,8.4
78,90,146,0,38,16,0,368,8.405
80,90,146,0,38,15,0,369,8.41
80,90,149,0,38,13,0,370,8.415
82,90,151,0,38,9,0,370,8.42
82,90,151,0,38,11,0,372,8.425
82,91,152,0,38,10,0,373,8.43
84,93,153,0,38,9,0,377,8.435
86,93,154,0,38,9,0,380,8.44
87,93,155,0,38,9,0,382,8.445
87,94,157,0,38,11,0,387,8.45
91,94,157,0,38,8,0,388,8.455
91,94,160,0,38,7,0,390,8.46
91,94,161,0,39,8,0,393,8.465
91,95,165,0,41,1,0,393,8.47
91,95,166,0,41,3,0,396,8.475
91,95,166,0,41,4,0,397,8.48
91,95,167,0,41,3,0,397,8.485
91,96,168,0,41,5,0,401,8.49
93,96,169,0,42,4,0,404,8.495
93,98,169,0,42,3,0,405,8.5
93,98,169,0,42,4,0,406,8.505
93,99,169,0,42,4,0,407,8.51
94,99,170,0,42,7,0,412,8.515
94,99,170,0,43,6,0,412,8.52
94,99,170,0,43,6,0,412,8.525
94,100,170,0,43,5,0,412,8.53
95,101,170,0,43,7,0,416,8.535
96,101,171,0,43,7,0,418,8.54
96,101,172,0,44,7,0,420,8.545
96,105,174,0,44,2,0,421,8.55
96,105,174,0,45,3,0,423,8.555
97,106,174,0,45,5,0,427,8.56
97,106,175,0,45,4,0,427,8.565
97,106,176,0,45,3,0,427,8.57
97,106,177,0,45,4,0,429,8.575
97,108,179,0,45,3,0,432,8.58
97,108,180,0,45,4,0,434,8.585
97,109,181,0,46,2,0,435,8.59
97,109,182,0,46,2,0,436,8.595
97,110,182,0,46,3,0,438,8.6
97,111,183,0,47,3,0,441,8.605
97,112,183,0,47,4,0,443,8.61
97,112,183,0,47,5,0,444,8.615
98,113,183,0,47,7,0,448,8.62
98,114,184,0,47,11,0,454,8.625
98,116,184,0,47,13,0,458,8.63
100,116,185,0,47,12,0,460,8.635
101,116,187,0,47,13,0,464,8.64
102,116,189,0,48,10,0,465,8.645
102,116,189,0,48,11,0,466,8.65
102,116,190,0,49,11,0,468,8.655
104,118,190,0,49,10,0,471,8.66
104,118,193,0,49,7,0,471,8.665
104,119,194,0,49,7,0,473,8.67
105,122,194,0,49,6,0,476,8.675
105,123,195,0,49,9,0,481,8.68
106,123,196,0,50,7,0,482,8.685
106,123,196,0,51,8,0,484,8.69
106,123,196,0,51,11,0,487,8.695
106,123,199,0,52,10,0,490,8.7
106,126,200,0,53,6,0,491,8.705
106,126,203,0,53,3,0,491,8.71
106,127,203,0,53,3,0,492,8.715
106,128,204,0,54,2,0,494,8.72
106,128,206,0,54,1,0,495,8.725
106,128,206,0,54,3,0,497,8.73
106,130,207,0,54,7,0,504,8.735
109,131,209,0,54,6,0,509,8.74
109,132,209,0,54,5,0,509,8.745
109,132,210,0,54,12,0,517,8.75
109,133,210,0,54,13,0,519,8.755
110,133,211,0,54,16,0,524,8.76
111,133,211,0,54,18,0,527,8.765
112,133,213,0,54,16,0,528,8.77
114,133,215,0,54,14,0,530,8.775
116,133,217,0,54,12,0,532,8.78
118,133,219,0,54,11,0,535,8.785
119,134,221,0,55,9,0,538,8.79
121,134,223,0,56,7,0,541,8.795
121,134,224,0,56,7,0,542,8.8
121,134,224,0,56,8,0,543,8.805
121,134,225,0,56,8,0,544,8.81
121,135,227,0,57,6,0,546,8.815
122,135,227,0,57,9,0,550,8.82
122,136,228,0,57,11,0,554,8.825
123,139,230,0,58,7,0,557,8.83
123,139,230,0,58,7,0,557,8.835
123,141,231,0,58,7,0,560,8.84
123,143,232,0,59,4,0,561,8.845
123,144,232,0,61,4,0,564,8.85
123,145,234,0,61,6,0,569,8.855
123,146,236,0,61,4,0,570,8.86
123,148,238,0,61,4,0,574,8.865
123,148,239,0,61,4,0,575,8.87
123,148,241,0,61,4,0,577,8.875
123,149,241,0,61,6,0,580,8.88
123,150,242,0,61,7,0,583,8.885
124,151,245,0,61,4,0,585,8.89
124,151,245,0,61,5,0,586,8.895
124,153,246,0,61,2,0,586,8.9
124,153,247,0,61,7,0,592,8.905
124,154,247,0,61,8,0,594,8.91
125,154,248,0,61,9,0,597,8.915
125,155,250,0,61,9,0,600,8.92
125,156,251,0,61,9,0,602,8.925
126,156,253,0,61,7,0,603,8.93
127,156,253,0,63,6,0,605,8.935
127,159,254,0,63,7,0,610,8.94
127,160,255,0,64,8,0,614,8.945
127,162,255,0,64,7,0,615,8.95
127,164,256,0,64,6,0,617,8.955
127,164,257,0,64,8,0,620,8.96
127,165,258,0,64,10,0,624,8.965
127,165,258,0,64,13,0,627,8.97
128,166,258,0,64,17,0,633,8.975
129,166,259,0,64,21,0,639,8.98
131,166,263,0,64,19,0,643,8.985
134,166,265,0,64,17,0,646,8.99
137,166,266,0,65,17,0,651,8.995
137,167,267,0,66,15,0,652,9
138,168,267,0,66,16,0,655,9.005
139,172,268,0,66,11,0,656,9.01
139,173,268,0,68,10,0,658,9.015
139,175,271,0,68,9,0,662,9.02
139,177,272,0,68,8,0,664,9.025
140,177,273,0,68,7,0,665,9.03
140,178,274,0,68,11,0,671,9.035
141,178,276,0,68,9,0,672,9.04
141,179,277,0,68,12,0,677,9.045
142,180,278,0,68,14,0,682,9.05
142,181,279,0,68,16,0,686,9.055
142,182,280,0,68,17,0,689,9.06
143,182,281,0,68,15,0,689,9.065
144,183,284,0,68,11,0,690,9.07
145,186,285,0,68,9,0,693,9.075
145,186,287,0,68,10,0,696,9.08
146,187,287,0,68,13,0,701,9.085
146,188,289,0,68,16,0,707,9.09
146,188,290,0,68,16,0,708,9.095
146,188,294,0,68,16,0,712,9.1
149,188,294,0,68,15,0,714,9.105
150,189,295,0,69,13,0,716,9.11
151,191,296,0,69,11,0,718,9.115
151,192,297,0,69,14,0,723,9.12
76,91,145,0,39,4,0,355,9.125
76,91,145,0,39,5,0,356,9.13
76,91,146,0,39,5,0,357,9.135
77,91,146,0,39,8,0,361,9.14
77,91,146,0,39,10,0,363,9.145
77,91,146,0,40,10,0,364,9.15
78,91,147,0,41,8,0,365,9.155
78,91,147,0,41,10,0,367,9.16
78,91,147,0,41,12,0,369,9.165
79,91,147,0,42,13,0,372,9.17
80,93,148,0,44,7,0,372,9.175
81,93,149,0,45,4,0,372,9.18
81,93,149,0,45,5,0,373,9.185
82,94,151,0,45,2,0,374,9.19
82,94,151,0,45,2,0,374,9.195
83,94,151,0,45,2,0,375,9.2
83,95,151,0,46,2,0,377,9.205
83,95,152,0,46,2,0,378,9.21
83,95,152,0,46,4,0,380,9.215
83,95,152,0,46,5,0,381,9.22
84,95,152,0,46,6,0,383,9.225
84,96,153,0,46,7,0,386,9.23
85,96,153,0,46,7,0,387,9.235
85,96,153,0,46,9,0,389,9.24
85,98,153,0,46,7,0,389,9.245
86,99,153,0,46,7,0,391,9.25
86,100,155,0,46,6,0,393,9.255
87,102,155,0,46,4,0,394,9.26
87,103,155,0,46,5,0,396,9.265
87,104,155,0,46,5,0,397,9.27
87,105,157,0,46,3,0,398,9.275
87,105,158,0,46,2,0,398,9.28
87,105,158,0,46,5,0,401,9.285
87,105,158,0,46,5,0,401,9.29
87,108,158,0,46,5,0,404,9.295
87,109,160,0,46,3,0,405,9.3
87,110,162,0,46,0,0,405,9.305
87,110,162,0,46,1,0,406,9.31
87,110,162,0,47,1,0,407,9.315
87,110,162,0,47,3,0,409,9.32
87,110,163,0,47,4,0,411,9.325
87,110,164,0,47,4,0,412,9.33
87,110,165,0,47,6,0,415,9.335
87,110,165,0,47,7,0,416,9.34
89,113,166,0,47,2,0,417,9.345
89,113,168,0,47,1,0,418,9.35
89,113,169,0,47,2,0,420,9.355
89,114,171,0,47,2,0,423,9.36
90,114,172,0,47,2,0,425,9.365
90,115,172,0,47,2,0,426,9.37
90,115,174,0,47,3,0,429,9.375
90,115,174,0,47,7,0,433,9.38
90,117,174,0,47,6,0,434,9.385
90,117,175,0,47,6,0,435,9.39
90,118,175,0,47,7,0,437,9.395
90,119,175,0,47,10,0,441,9.4
90,119,176,0,47,15,0,447,9.405
91,119,176,0,48,15,0,449,9.41
94,120,176,0,48,14,0,452,9.415
94,121,177,0,49,12,0,453,9.42
94,121,179,0,49,13,0,456,9.425
94,122,179,0,49,15,0,459,9.43
94,122,183,0,49,12,0,460,9.435
95,123,184,0,49,9,0,460,9.44
97,124,185,0,49,8,0,463,9.445
97,124,185,0,50,9,0,465,9.45
97,125,186,0,50,9,0,467,9.455
98,125,186,0,50,10,0,469,9.46
98,128,187,0,50,9,0,472,9.465
98,131,187,0,50,8,0,474,9.47
98,133,187,0,52,6,0,476,9.475
98,133,189,0,52,7,0,479,9.48
98,133,191,0,52,8,0,482,9.485
98,133,191,0,52,14,0,488,9.49
99,133,194,0,52,14,0,492,9.495
99,134,195,0,53,14,0,495,9.5
100,134,195,0,53,13,0,495,9.505
101,136,202,0,53,3,0,495,9.51
101,138,202,0,53,3,0,497,9.515
101,138,202,0,53,4,0,498,9.52
101,138,202,0,53,7,0,501,9.525
101,138,203,0,53,6,0,501,9.53
101,138,204,0,54,5,0,502,9.535
101,140,205,0,54,2,0,502,9.54
101,141,206,0,54,2,0,504,9.545
101,141,209,0,54,0,0,505,9.55
101,142,209,0,55,1,0,508,9.555
102,142,209,0,55,3,0,511,9.56
103,142,209,0,55,7,0,516,9.565
103,142,209,0,55,10,0,519,9.57
104,143,210,0,55,8,0,520,9.575
105,143,210,0,55,9,0,522,9.58
106,143,210,0,56,12,0,527,9.585
107,143,210,0,56,12,0,528,9.59
108,144,215,0,56,8,0,531,9.595
110,144,218,0,56,4,0,532,9.6
110,144,221,0,56,5,0,536,9.605
110,145,221,0,56,5,0,537,9.61
110,145,222,0,56,8,0,541,9.615
111,147,222,0,57,5,0,542,9.62
111,148,223,0,57,9,0,548,9.625
112,149,225,0,57,8,0,551,9.63
112,149,226,0,57,11,0,555,9.635
114,150,228,0,57,9,0,558,9.64
115,151,229,0,57,7,0,559,9.645
116,151,230,0,57,9,0,563,9.65
116,152,232,0,57,6,0,563,9.655
116,154,233,0,57,6,0,566,9.66
116,155,234,0,57,4,0,566,9.665
116,156,235,0,57,4,0,568,9.67
116,156,235,0,57,7,0,571,9.675
116,156,235,0,57,12,0,576,9.68
117,156,237,0,57,9,0,576,9.685
119,157,238,0,57,6,0,577,9.69
119,158,239,0,58,5,0,579,9.695
119,158,239,0,58,8,0,582,9.7
119,160,239,0,58,9,0,585,9.705
119,160,240,0,58,10,0,587,9.71
120,160,241,0,59,13,0,593,9.715
120,160,242,0,59,13,0,594,9.72
120,160,243,0,60,17,0,600,9.725
122,160,246,0,60,14,0,602,9.73
124,160,246,0,60,13,0,603,9.735
126,161,248,0,60,13,0,608,9.74
126,162,249,0,60,12,0,609,9.745
128,163,250,0,60,12,0,613,9.75
128,163,251,0,61,13,0,616,9.755
129,164,252,0,61,11,0,617,9.76
130,164,252,0,61,12,0,619,9.765
130,164,254,0,61,12,0,621,9.77
130,164,256,0,61,13,0,624,9.775
130,164,256,0,61,15,0,626,9.78
130,165,257,0,61,14,0,627,9.785
131,167,257,0,61,13,0,629,9.79
134,168,259,0,61,9,0,631,9.795
134,169,259,0,62,11,0,635,9.8
136,170,259,0,63,8,0,636,9.805
136,171,259,0,63,7,0,636,9.81
136,171,260,0,63,8,0,638,9.815
137,173,262,0,63,8,0,643,9.82
138,175,262,0,63,6,0,644,9.825
138,177,262,0,63,5,0,645,9.83
139,178,264,0,63,4,0,648,9.835
140,178,267,0,63,4,0,652,9.84
141,179,269,0,64,3,0,656,9.845
141,180,271,0,64,1,0,657,9.85
141,180,272,0,64,2,0,659,9.855
141,182,272,0,64,1,0,660,9.86
141,182,273,0,65,0,0,661,9.865
141,183,273,0,65,3,0,665,9.87
141,184,273,0,66,5,0,669,9.875
141,186,273,0,66,8,0,674,9.88
142,187,274,0,66,7,0,676,9.885
142,189,276,0,66,6,0,679,9.89
142,191,276,0,66,4,0,679,9.895
142,192,277,0,66,5,0,682,9.9
143,194,278,0,67,3,0,685,9.905
143,195,278,0,67,6,0,689,9.91
144,196,280,0,67,5,0,692,9.915
144,196,282,0,67,4,0,693,9.92
144,198,282,0,67,4,0,695,9.925
145,200,282,0,68,5,0,700,9.93
145,203,283,0,68,5,0,704,9.935
145,203,284,0,69,9,0,710,9.94
145,204,285,0,69,10,0,713,9.945
145,204,285,0,69,13,0,716,9.95
147,204,287,0,69,12,0,719,9.955
75,93,136,0,32,7,0,343,9.96
76,95,137,0,32,3,0,343,9.965
76,95,137,0,32,7,0,347,9.97
77,95,139,0,32,6,0,349,9.975
77,97,141,0,32,3,0,350,9.98
77,97,142,0,33,3,0,352,9.985
78,99,142,0,33,3,0,355,9.99
78,99,143,0,33,6,0,359,9.995
78,100,144,0,33,8,0,363,10
79,100,144,0,33,9,0,365,10.005
79,100,145,0,33,8,0,365,10.01
79,100,147,0,33,12,0,371,10.015
81,100,147,0,33,13,0,374,10.02
84,100,148,0,33,11,0,376,10.025
84,100,148,0,33,14,0,379,10.03
84,100,153,0,33,9,0,379,10.035
85,101,153,0,34,7,0,380,10.04
85,101,154,0,34,8,0,382,10.045
85,101,156,0,34,9,0,385,10.05
85,102,156,0,34,10,0,387,10.055
85,103,158,0,34,9,0,389,10.06
88,104,159,0,34,4,0,389,10.065
88,104,160,0,34,4,0,390,10.07
88,104,161,0,35,3,0,391,10.075
89,104,161,0,35,3,0,392,10.08
89,104,163,0,35,3,0,394,10.085
89,104,163,0,35,4,0,395,10.09
89,105,163,0,36,2,0,395,10.095
89,105,164,0,36,1,0,395,10.1
89,105,164,0,36,3,0,397,10.105
89,106,164,0,36,7,0,402,10.11
90,106,165,0,36,7,0,404,10.115
90,106,166,0,36,6,0,404,10.12
90,107,166,0,36,6,0,405,10.125
90,107,166,0,37,7,0,407,10.13
90,107,168,0,37,6,0,408,10.135
90,107,168,0,37,7,0,409,10.14
90,109,169,0,37,4,0,409,10.145
90,111,170,0,37,2,0,410,10.15
90,111,170,0,37,7,0,415,10.155
91,112,171,0,38,8,0,420,10.16
91,114,172,0,39,5,0,421,10.165
91,114,173,0,39,8,0,425,10.17
92,116,173,0,40,7,0,428,10.175
92,116,174,0,40,7,0,429,10.18
92,117,177,0,40,3,0,429,10.185
92,117,177,0,40,5,0,431,10.19
92,119,179,0,40,1,0,431,10.195
92,119,179,0,40,4,0,434,10.2
92,119,180,0,40,5,0,436,10.205
94,120,180,0,40,5,0,439,10.21
94,122,180,0,40,8,0,444,10.215
95,123,180,0,40,7,0,445,10.22
95,123,180,0,41,6,0,445,10.225
95,125,180,0,41,5,0,446,10.23
95,126,180,0,41,5,0,447,10.235
95,126,180,0,41,9,0,451,10.24
96,127,180,0,41,11,0,455,10.245
96,127,181,0,41,13,0,458,10.25
97,127,183,0,41,12,0,460,10.255
98,127,184,0,41,14,0,464,10.26
98,127,186,0,41,16,0,468,10.265
100,127,186,0,42,14,0,469,10.27
100,128,188,0,43,12,0,471,10.275
100,128,188,0,44,13,0,473,10.28
100,128,189,0,44,16,0,477,10.285
101,128,189,0,45,15,0,478,10.29
102,128,190,0,45,15,0,480,10.295
104,130,191,0,45,11,0,481,10.3
105,130,193,0,46,11,0,485,10.305
105,131,195,0,47,9,0,487,10.31
105,131,196,0,47,9,0,488,10.315
105,131,196,0,47,11,0,490,10.32
107,131,196,0,48,13,0,495,10.325
107,131,197,0,50,14,0,499,10.33
108,132,199,0,50,16,0,505,10.335
108,132,199,0,50,19,0,508,10.34
109,133,200,0,51,17,0,510,10.345
110,133,200,0,51,21,0,515,10.35
111,133,202,0,52,20,0,518,10.355
111,134,204,0,52,18,0,519,10.36
112,134,205,0,52,20,0,523,10.365
113,134,206,0,52,20,0,525,10.37
113,135,207,0,52,20,0,527,10.375
113,135,207,0,53,19,0,527,10.38
113,135,208,0,54,22,0,532,10.385
115,135,209,0,55,21,0,535,10.39
116,135,209,0,58,19,0,537,10.395
116,135,210,0,58,21,0,540,10.4
117,136,210,0,59,21,0,543,10.405
117,136,210,0,59,25,0,547,10.41
118,136,212,0,59,24,0,549,10.415
120,137,215,0,60,19,0,551,10.42
121,138,218,0,61,20,0,558,10.425
123,140,219,0,61,18,0,561,10.43
124,140,221,0,61,19,0,565,10.435
124,140,221,0,61,23,0,569,10.44
125,141,221,0,62,21,0,570,10.445
125,141,222,0,63,20,0,571,10.45
126,141,224,0,63,20,0,574,10.455
127,141,224,0,65,18,0,575,10.46
128,142,225,0,65,21,0,581,10.465
129,142,227,0,65,22,0,585,10.47
131,143,227,0,65,22,0,588,10.475
132,143,229,0,65,24,0,593,10.48
134,144,231,0,65,20,0,594,10.485
134,146,231,0,65,20,0,596,10.49
134,146,232,0,66,18,0,596,10.495
136,146,234,0,68,16,0,600,10.5
137,146,234,0,68,18,0,603,10.505
139,146,236,0,68,17,0,606,10.51
140,147,236,0,68,17,0,608,10.515
140,147,237,0,68,21,0,613,10.52
142,148,241,0,69,14,0,614,10.525
74,79,127,0,29,8,0,317,10.53
74,79,127,0,29,9,0,318,10.535
74,80,128,0,29,8,0,319,10.54
74,81,128,0,29,9,0,321,10.545
74,82,128,0,29,11,0,324,10.55
74,82,128,0,29,12,0,325,10.555
74,83,128,0,29,13,0,327,10.56
74,83,130,0,29,12,0,328,10.565
75,83,130,0,30,12,0,330,10.57
76,83,132,0,30,11,0,332,10.575
76,83,133,0,30,13,0,335,10.58
77,83,134,0,30,12,0,336,10.585
78,83,134,0,30,12,0,337,10.59
78,85,135,0,30,11,0,339,10.595
78,85,137,0,30,10,0,340,10.6
78,85,138,0,30,10,0,341,10.605
80,86,138,0,30,7,0,341,10.61
80,86,138,0,30,10,0,344,10.615
81,86,139,0,30,9,0,345,10.62
81,86,140,0,30,12,0,349,10.625
81,86,141,0,30,12,0,350,10.63
81,86,143,0,30,12,0,352,10.635
82,86,144,0,30,11,0,353,10.64
83,86,145,0,30,10,0,354,10.645
84,87,146,0,30,8,0,355,10.65
85,88,148,0,30,7,0,358,10.655
85,88,149,0,30,7,0,359,10.66
87,88,151,0,30,5,0,361,10.665
87,88,152,0,30,4,0,361,10.67
87,90,153,0,30,3,0,363,10.675
87,91,153,0,30,8,0,369,10.68
87,92,153,0,30,9,0,371,10.685
87,92,154,0,30,8,0,371,10.69
88,93,156,0,30,5,0,372,10.695
88,93,157,0,30,7,0,375,10.7
88,94,158,0,30,7,0,377,10.705
88,94,160,0,30,5,0,377,10.71
88,96,161,0,30,3,0,378,10.715
88,97,161,0,30,4,0,380,10.72
88,97,161,0,30,5,0,381,10.725
88,99,161,0,30,8,0,386,10.73
88,102,163,0,30,3,0,386,10.735
88,103,163,0,32,3,0,389,10.74
89,103,164,0,32,5,0,393,10.745
89,105,165,0,33,4,0,396,10.75
89,106,165,0,33,4,0,397,10.755
89,106,165,0,34,6,0,400,10.76
89,107,165,0,34,6,0,401,10.765
89,107,168,0,34,5,0,403,10.77
89,109,169,0,34,6,0,407,10.775
89,109,169,0,34,7,0,408,10.78
89,110,169,0,34,7,0,409,10.785
89,110,170,0,34,8,0,411,10.79
89,110,170,0,34,10,0,413,10.795
89,110,172,0,35,12,0,418,10.8
89,110,172,0,35,13,0,419,10.805
89,111,172,0,35,13,0,420,10.81
89,111,173,0,35,13,0,421,10.815
89,112,174,0,36,11,0,422,10.82
89,114,175,0,36,9,0,423,10.825
89,114,176,0,36,9,0,424,10.83
89,114,177,0,37,12,0,429,10.835
89,114,179,0,38,12,0,432,10.84
89,114,179,0,39,12,0,433,10.845
89,116,180,0,39,12,0,436,10.85
91,117,180,0,39,10,0,437,10.855
92,118,180,0,39,10,0,439,10.86
92,118,180,0,39,13,0,442,10.865
94,118,180,0,40,13,0,445,10.87
95,118,180,0,40,14,0,447,10.875
95,118,181,0,41,13,0,448,10.88
95,118,182,0,41,14,0,450,10.885
96,118,183,0,41,13,0,451,10.89
96,118,184,0,41,13,0,452,10.895
96,119,184,0,41,13,0,453,10.9
96,119,184,0,41,14,0,454,10.905
96,119,185,0,42,12,0,454,10.91
96,119,186,0,42,13,0,456,10.915
96,119,187,0,43,12,0,457,10.92
97,119,189,0,43,12,0,460,10.925
99,120,189,0,44,11,0,463,10.93
99,122,189,0,44,10,0,464,10.935
99,124,190,0,44,9,0,466,10.94
99,126,190,0,44,9,0,468,10.945
99,126,192,0,45,7,0,469,10.95
100,126,194,0,46,6,0,472,10.955
100,126,195,0,46,12,0,479,10.96
101,127,195,0,46,12,0,481,10.965
101,127,196,0,46,15,0,485,10.97
102,128,198,0,46,16,0,490,10.975
103,128,198,0,46,18,0,493,10.98
104,129,199,0,47,17,0,496,10.985
105,129,201,0,47,17,0,499,10.99
105,130,204,0,47,15,0,501,10.995
106,130,206,0,47,13,0,502,11
106,130,210,0,47,12,0,505,11.005
108,130,211,0,48,10,0,507,11.01
109,130,211,0,49,14,0,513,11.015
109,130,211,0,49,17,0,516,11.02
110,130,213,0,49,15,0,517,11.025
110,131,214,0,49,13,0,517,11.03
111,133,214,0,49,11,0,518,11.035
112,133,214,0,49,13,0,521,11.04
114,134,214,0,49,10,0,521,11.045
115,137,214,0,49,9,0,524,11.05
115,137,216,0,49,12,0,529,11.055
115,138,218,0,49,11,0,531,11.06
115,141,218,0,50,11,0,535,11.065
115,141,218,0,50,14,0,538,11.07
115,141,221,0,50,14,0,541,11.075
115,144,221,0,51,11,0,542,11.08
115,144,222,0,52,10,0,543,11.085
115,144,222,0,52,10,0,543,11.09
116,145,223,0,53,10,0,547,11.095
117,145,223,0,53,11,0,549,11.1
120,146,224,0,54,9,0,553,11.105
120,146,224,0,54,9,0,553,11.11
121,147,224,0,54,9,0,555,11.115
121,147,225,0,54,10,0,557,11.12
121,147,228,0,54,8,0,558,11.125
121,148,230,0,54,5,0,558,11.13
121,151,231,0,54,4,0,561,11.135
121,151,233,0,54,5,0,564,11.14
121,151,234,0,54,9,0,569,11.145
121,152,235,0,54,13,0,575,11.15
122,154,235,0,54,12,0,577,11.155
122,156,235,0,54,14,0,581,11.16
123,157,236,0,54,14,0,584,11.165
124,158,237,0,55,15,0,589,11.17
124,158,238,0,55,14,0,589,11.175
124,159,238,0,55,15,0,591,11.18
125,160,239,0,55,14,0,593,11.185
125,161,242,0,55,11,0,594,11.19
126,163,243,0,56,9,0,597,11.195
126,163,244,0,56,13,0,602,11.2
128,165,244,0,57,10,0,604,11.205
128,168,245,0,57,8,0,606,11.21
129,169,245,0,57,9,0,609,11.215
129,171,245,0,58,9,0,612,11.22
130,172,247,0,58,5,0,612,11.225
130,173,247,0,58,5,0,613,11.23
130,173,250,0,58,3,0,614,11.235
131,174,251,0,58,4,0,618,11.24
132,174,252,0,58,5,0,621,11.245
132,175,256,0,58,4,0,625,11.25
132,175,256,0,58,6,0,627,11.255
133,176,256,0,58,8,0,631,11.26
133,177,257,0,59,7,0,633,11.265
133,177,257,0,59,11,0,637,11.27
134,178,258,0,59,11,0,640,11.275
134,179,259,0,59,10,0,641,11.28
134,179,261,0,59,8,0,641,11.285
134,179,263,0,59,10,0,645,11.29
134,180,269,0,60,7,0,650,11.295
134,183,269,0,60,4,0,650,11.3
134,184,271,0,60,7,0,656,11.305
135,186,271,0,60,5,0,657,11.31
137,187,272,0,60,6,0,662,11.315
137,187,273,0,60,7,0,664,11.32
137,188,275,0,60,7,0,667,11.325
137,189,277,0,60,6,0,669,11.33
137,192,278,0,60,5,0,672,11.335
138,194,278,0,60,5,0,675,11.34
138,194,278,0,60,9,0,679,11.345
140,195,282,0,60,5,0,682,11.35
140,197,284,0,60,6,0,687,11.355
140,198,285,0,60,6,0,689,11.36
140,198,286,0,60,8,0,692,11.365
140,198,287,0,61,15,0,701,11.37
141,199,287,0,61,16,0,704,11.375
142,201,287,0,61,20,0,711,11.38
144,201,288,0,62,20,0,715,11.385
144,201,290,0,62,23,0,720,11.39
144,203,291,0,62,23,0,723,11.395
144,205,291,0,62,28,0,730,11.4
146,206,294,0,62,22,0,730,11.405
147,206,296,0,62,21,0,732,11.41
148,207,297,0,62,20,0,734,11.415
148,207,300,0,62,21,0,738,11.42
149,208,301,0,62,22,0,742,11.425
150,210,301,0,62,21,0,744,11.43
150,210,305,0,62,19,0,746,11.435
152,211,306,0,62,17,0,748,11.44
154,214,308,0,62,11,0,749,11.445
154,214,309,0,62,13,0,752,11.45
154,217,310,0,62,12,0,755,11.455
154,217,312,0,62,13,0,758,11.46
155,218,313,0,62,13,0,761,11.465
155,220,314,0,63,14,0,766,11.47
155,221,314,0,63,20,0,773,11.475
155,221,315,0,63,24,0,778,11.48
158,221,317,0,64,20,0,780,11.485
159,221,318,0,64,21,0,783,11.49
160,221,320,0,65,21,0,787,11.495
161,222,320,0,65,20,0,788,11.5
161,223,321,0,65,23,0,793,11.505
163,224,323,0,65,19,0,794,11.51
163,226,325,0,66,18,0,798,11.515
163,227,327,0,66,18,0,801,11.52
164,227,327,0,66,21,0,805,11.525
165,227,328,0,66,22,0,808,11.53
166,227,329,0,66,23,0,811,11.535
166,227,332,0,66,25,0,816,11.54
168,227,332,0,67,24,0,818,11.545
170,228,332,0,67,26,0,823,11.55
171,228,333,0,68,27,0,827,11.555
171,228,335,0,68,31,0,833,11.56
172,228,337,0,68,32,0,837,11.565
91,119,161,0,30,15,0,416,11.57
91,120,164,0,30,11,0,416,11.575
91,120,165,0,30,12,0,418,11.58
91,120,167,0,31,12,0,421,11.585
91,121,169,0,31,11,0,423,11.59
92,122,169,0,31,9,0,423,11.595
92,122,169,0,32,10,0,425,11.6
94,123,172,0,32,6,0,427,11.605
94,124,172,0,32,7,0,429,11.61
94,124,176,0,32,6,0,432,11.615
95,124,176,0,32,7,0,434,11.62
95,125,178,0,32,8,0,438,11.625
95,126,178,0,32,10,0,441,11.63
96,127,178,0,32,10,0,443,11.635
96,128,179,0,32,12,0,447,11.64
96,130,181,0,32,11,0,450,11.645
96,130,183,0,32,11,0,452,11.65
96,130,184,0,33,10,0,453,11.655
97,130,185,0,33,11,0,456,11.66
97,131,187,0,34,9,0,458,11.665
98,131,187,0,35,9,0,460,11.67
99,132,187,0,35,8,0,461,11.675
99,132,187,0,35,10,0,463,11.68
99,132,188,0,35,11,0,465,11.685
99,134,188,0,35,9,0,465,11.69
99,135,189,0,35,9,0,467,11.695
99,135,190,0,35,9,0,468,11.7
99,135,191,0,36,10,0,471,11.705
99,136,192,0,36,10,0,473,11.71
100,136,192,0,36,10,0,474,11.715
100,136,193,0,36,11,0,476,11.72
100,136,195,0,36,11,0,478,11.725
101,137,196,0,37,11,0,482,11.73
102,137,198,0,37,9,0,483,11.735
102,138,199,0,37,10,0,486,11.74
102,138,202,0,37,9,0,488,11.745
102,140,203,0,37,8,0,490,11.75
102,142,203,0,37,9,0,493,11.755
103,142,203,0,38,8,0,494,11.76
103,142,203,0,38,13,0,499,11.765
103,142,206,0,38,13,0,502,11.77
103,142,206,0,38,15,0,504,11.775
104,142,207,0,38,15,0,506,11.78
104,142,208,0,38,17,0,509,11.785
104,143,208,0,38,21,0,514,11.79
104,144,210,0,39,18,0,515,11.795
105,144,211,0,40,17,0,517,11.8
107,145,213,0,40,13,0,518,11.805
107,147,214,0,40,11,0,519,11.81
107,148,215,0,40,11,0,521,11.815
109,149,216,0,40,9,0,523,11.82
109,150,218,0,42,7,0,526,11.825
110,150,218,0,43,10,0,531,11.83
110,151,219,0,43,11,0,534,11.835
110,153,222,0,43,11,0,539,11.84
111,154,222,0,43,12,0,542,11.845
112,154,224,0,43,11,0,544,11.85
113,155,225,0,43,10,0,546,11.855
113,155,227,0,43,13,0,551,11.86
113,155,227,0,45,16,0,556,11.865
113,155,228,0,45,25,0,566,11.87
115,155,228,0,45,27,0,570,11.875
115,155,229,0,45,27,0,571,11.88
116,156,229,0,47,24,0,572,11.885
118,157,232,0,47,18,0,572,11.89
119,157,232,0,47,21,0,576,11.895
121,157,233,0,48,21,0,580,11.9
121,158,234,0,48,20,0,581,11.905
122,160,234,0,49,17,0,582,11.91
124,164,235,0,50,13,0,586,11.915
124,164,237,0,50,13,0,588,11.92
124,165,237,0,50,14,0,590,11.925
125,165,239,0,50,13,0,592,11.93
126,165,242,0,51,10,0,594,11.935
127,165,242,0,51,13,0,598,11.94
127,166,242,0,51,13,0,599,11.945
127,166,244,0,52,12,0,601,11.95
127,167,244,0,52,15,0,605,11.955
128,168,245,0,52,16,0,609,11.96
131,170,245,0,52,13,0,611,11.965
132,172,246,0,52,12,0,614,11.97
132,173,248,0,52,12,0,617,11.975
132,175,249,0,52,13,0,621,11.98
132,177,253,0,52,12,0,626,11.985
134,177,253,0,52,11,0,627,11.99
135,179,256,0,52,5,0,627,11.995
135,183,257,0,52,3,0,630,12
135,184,260,0,52,2,0,633,12.005
135,186,260,0,52,2,0,635,12.01
135,187,261,0,52,3,0,638,12.015
135,189,261,0,52,4,0,641,12.02
136,190,261,0,52,7,0,646,12.025
137,190,262,0,52,8,0,649,12.03
138,191,263,0,52,8,0,652,12.035
138,193,263,0,52,9,0,655,12.04
138,193,264,0,52,13,0,660,12.045
138,194,264,0,52,19,0,667,12.05
139,194,265,0,52,19,0,669,12.055
139,195,268,0,53,17,0,672,12.06
140,195,270,0,54,15,0,674,12.065
140,195,271,0,54,20,0,680,12.07
140,195,273,0,54,19,0,681,12.075
140,195,274,0,54,22,0,685,12.08
141,195,277,0,54,21,0,688,12.085
142,195,279,0,54,24,0,694,12.09
142,195,280,0,56,22,0,695,12.095
147,195,282,0,57,18,0,699,12.1
147,198,283,0,57,17,0,702,12.105
148,199,284,0,58,18,0,707,12.11
148,200,288,0,59,17,0,712,12.115
150,200,289,0,59,16,0,714,12.12
151,201,291,0,59,18,0,720,12.125
154,201,292,0,59,18,0,724,12.13
154,201,296,0,59,16,0,726,12.135
154,203,300,0,59,15,0,731,12.14
155,204,301,0,59,15,0,734,12.145
156,207,302,0,59,11,0,735,12.15
156,208,303,0,59,16,0,742,12.155
156,210,304,0,59,16,0,745,12.16
156,210,306,0,60,14,0,746,12.165
157,210,307,0,60,18,0,752,12.17
157,210,309,0,60,20,0,756,12.175
158,211,309,0,60,26,0,764,12.18
159,211,310,0,60,27,0,767,12.185
162,214,311,0,60,23,0,770,12.19
163,214,315,0,60,21,0,773,12.195
165,214,317,0,60,22,0,778,12.2
167,215,318,0,61,21,0,782,12.205
167,217,319,0,62,25,0,790,12.21
167,218,322,0,62,23,0,792,12.215
169,220,323,0,62,24,0,798,12.22
173,221,325,0,62,19,0,800,12.225
174,221,328,0,62,19,0,804,12.23
175,223,329,0,62,18,0,807,12.235
176,224,331,0,64,17,0,812,12.24
178,224,331,0,65,20,0,818,12.245
180,224,331,0,65,20,0,820,12.25
180,225,333,0,65,22,0,825,12.255
181,226,337,0,65,17,0,826,12.26
181,227,337,0,66,16,0,827,12.265
181,227,338,0,66,19,0,831,12.27
181,229,339,0,67,19,0,835,12.275
183,230,339,0,67,19,0,838,12.28
184,231,339,0,68,21,0,843,12.285
185,233,339,0,68,22,0,847,12.29
186,234,342,0,68,20,0,850,12.295
187,236,343,0,69,21,0,856,12.3
93,122,190,0,38,10,0,453,12.305
94,123,191,0,38,11,0,457,12.31
94,123,193,0,38,11,0,459,12.315
94,124,194,0,39,8,0,459,12.32
94,124,195,0,39,11,0,463,12.325
95,125,198,0,39,7,0,464,12.33
96,126,198,0,39,9,0,468,12.335
96,128,199,0,39,8,0,470,12.34
96,128,199,0,39,8,0,470,12.345
96,128,202,0,39,5,0,470,12.35
96,128,202,0,39,9,0,474,12.355
96,128,202,0,39,12,0,477,12.36
96,128,202,0,39,12,0,477,12.365
97,130,204,0,40,9,0,480,12.37
97,131,204,0,41,8,0,481,12.375
97,132,206,0,41,8,0,484,12.38
97,133,207,0,41,7,0,485,12.385
98,133,207,0,41,10,0,489,12.39
99,134,207,0,41,13,0,494,12.395
100,134,207,0,41,15,0,497,12.4
102,134,207,0,41,13,0,497,12.405
103,134,209,0,41,13,0,500,12.41
104,134,209,0,41,14,0,502,12.415
104,134,210,0,41,13,0,502,12.42
104,135,210,0,41,15,0,505,12.425
104,135,211,0,42,17,0,509,12.43
104,135,212,0,42,18,0,511,12.435
105,135,213,0,43,16,0,512,12.44
106,137,214,0,43,14,0,514,12.445
108,138,214,0,44,14,0,518,12.45
109,138,214,0,44,16,0,521,12.455
109,139,215,0,45,13,0,521,12.46
110,140,217,0,46,13,0,526,12.465
110,141,217,0,46,16,0,530,12.47
111,142,219,0,46,13,0,531,12.475
111,143,220,0,46,14,0,534,12.48
112,143,221,0,46,15,0,537,12.485
114,144,221,0,46,12,0,537,12.49
115,144,222,0,46,14,0,541,12.495
116,144,223,0,46,14,0,543,12.5
116,144,223,0,46,18,0,547,12.505
118,145,223,0,46,20,0,552,12.51
118,146,223,0,47,18,0,552,12.515
119,146,223,0,48,18,0,554,12.52
119,147,223,0,48,18,0,555,12.525
120,147,223,0,48,19,0,557,12.53
121,147,223,0,48,18,0,557,12.535
125,147,226,0,48,12,0,558,12.54
127,147,227,0,48,11,0,560,12.545
128,148,229,0,48,10,0,563,12.55
128,149,230,0,48,10,0,565,12.555
129,150,231,0,48,8,0,566,12.56
129,151,233,0,48,8,0,569,12.565
131,154,233,0,48,6,0,572,12.57
132,155,234,0,48,8,0,577,12.575
132,156,236,0,49,5,0,578,12.58
133,157,237,0,49,5,0,581,12.585
133,159,237,0,50,3,0,582,12.59
133,159,238,0,50,3,0,583,12.595
133,160,238,0,50,5,0,586,12.6
134,162,238,0,50,3,0,587,12.605
134,163,238,0,50,4,0,589,12.61
134,169,238,0,50,2,0,593,12.615
134,171,239,0,50,2,0,596,12.62
134,172,239,0,50,3,0,598,12.625
134,173,240,0,50,8,0,605,12.63
134,176,242,0,50,7,0,609,12.635
134,178,243,0,50,6,0,611,12.64
135,179,244,0,51,6,0,615,12.645
136,180,245,0,51,7,0,619,12.65
136,184,245,0,51,9,0,625,12.655
137,185,245,0,51,12,0,630,12.66
139,186,245,0,51,11,0,632,12.665
141,187,245,0,52,9,0,634,12.67
141,187,247,0,52,12,0,639,12.675
142,188,248,0,52,14,0,644,12.68
143,190,250,0,53,14,0,650,12.685
143,191,251,0,54,13,0,652,12.69
144,192,253,0,54,13,0,656,12.695
144,193,257,0,54,11,0,659,12.7
144,193,259,0,54,11,0,661,12.705
145,194,260,0,54,14,0,667,12.71
145,195,261,0,54,15,0,670,12.715
146,198,262,0,54,12,0,672,12.72
147,200,263,0,54,11,0,675,12.725
147,201,264,0,54,12,0,678,12.73
148,202,264,0,54,12,0,680,12.735
149,202,267,0,54,13,0,685,12.74
149,202,268,0,54,17,0,690,12.745
149,202,270,0,54,16,0,691,12.75
149,203,272,0,54,16,0,694,12.755
149,205,274,0,55,14,0,697,12.76
150,205,276,0,55,17,0,703,12.765
150,206,278,0,56,16,0,706,12.77
150,208,278,0,57,18,0,711,12.775
151,209,279,0,57,17,0,713,12.78
151,210,279,0,57,20,0,717,12.785
152,214,284,0,57,14,0,721,12.79
153,215,286,0,57,12,0,723,12.795
153,217,287,0,57,13,0,727,12.8
153,217,287,0,57,19,0,733,12.805
154,219,290,0,58,13,0,734,12.81
155,220,290,0,58,17,0,740,12.815
155,221,291,0,58,19,0,744,12.82
155,221,292,0,58,23,0,749,12.825
155,221,294,0,58,26,0,754,12.83
157,222,295,0,58,23,0,755,12.835
158,223,297,0,59,20,0,757,12.84
159,224,298,0,60,19,0,760,12.845
159,225,300,0,60,17,0,761,12.85
162,228,302,0,60,11,0,763,12.855
163,229,303,0,60,12,0,767,12.86
163,231,305,0,60,11,0,770,12.865
163,234,306,0,60,9,0,772,12.87
164,235,307,0,60,8,0,774,12.875
164,236,309,0,60,8,0,777,12.88
164,237,313,0,60,11,0,785,12.885
165,239,314,0,60,14,0,792,12.89
166,239,316,0,62,13,0,796,12.895
166,239,318,0,62,19,0,804,12.9
166,239,320,0,62,26,0,813,12.905
166,239,322,0,62,28,0,817,12.91
168,241,322,0,63,25,0,819,12.915
170,241,322,0,64,26,0,823,12.92
171,242,323,0,64,25,0,825,12.925
172,242,324,0,65,24,0,827,12.93
173,242,325,0,66,31,0,837,12.935
175,242,327,0,66,32,0,842,12.94
176,245,328,0,66,29,0,844,12.945
179,245,328,0,66,29,0,847,12.95
182,245,328,0,66,28,0,849,12.955
187,245,330,0,67,25,0,854,12.96
188,245,331,0,67,28,0,859,12.965
190,247,332,0,67,24,0,860,12.97
193,251,334,0,67,20,0,865,12.975
194,252,335,0,68,17,0,866,12.98
195,253,338,0,68,14,0,868,12.985
197,257,340,0,69,8,0,871,12.99
198,258,344,0,69,4,0,873,12.995
106,131,172,0,26,7,0,442,13
106,131,172,0,26,8,0,443,13.005
106,131,172,0,26,13,0,448,13.01
109,131,172,0,26,10,0,448,13.015
109,131,173,0,27,8,0,448,13.02
109,132,174,0,27,8,0,450,13.025
110,132,176,0,27,10,0,455,13.03
111,136,176,0,27,5,0,455,13.035
111,136,176,0,27,9,0,459,13.04
112,138,176,0,27,6,0,459,13.045
113,139,177,0,27,5,0,461,13.05
113,139,177,0,27,8,0,464,13.055
113,139,179,0,27,7,0,465,13.06
113,140,180,0,28,5,0,466,13.065
113,140,181,0,28,8,0,470,13.07
113,142,181,0,28,8,0,472,13.075
113,143,183,0,28,7,0,474,13.08
113,143,184,0,28,8,0,476,13.085
114,143,184,0,29,9,0,479,13.09
117,143,184,0,29,8,0,481,13.095
117,144,184,0,30,8,0,483,13.1
117,145,186,0,30,9,0,487,13.105
118,147,187,0,30,5,0,487,13.11
118,148,187,0,30,6,0,489,13.115
120,148,187,0,30,9,0,494,13.12
120,149,187,0,31,9,0,496,13.125
122,149,189,0,31,6,0,497,13.13
123,149,191,0,31,5,0,499,13.135
123,149,191,0,31,6,0,500,13.14
123,150,193,0,31,6,0,503,13.145
124,152,194,0,32,3,0,505,13.15
124,153,195,0,32,4,0,508,13.155
124,154,195,0,32,5,0,510,13.16
124,154,195,0,32,10,0,515,13.165
126,154,195,0,32,12,0,519,13.17
126,154,197,0,33,11,0,521,13.175
127,155,197,0,33,11,0,523,13.18
127,156,199,0,33,11,0,526,13.185
128,160,200,0,33,10,0,531,13.19
129,160,200,0,34,11,0,534,13.195
129,161,200,0,34,13,0,537,13.2
130,161,202,0,35,13,0,541,13.205
131,162,202,0,35,13,0,543,13.21
132,162,203,0,35,13,0,545,13.215
134,162,205,0,37,9,0,547,13.22
135,162,208,0,38,8,0,551,13.225
136,162,209,0,38,10,0,555,13.23
136,162,212,0,38,8,0,556,13.235
136,163,213,0,38,8,0,558,13.24
137,163,215,0,38,5,0,558,13.245
137,164,218,0,38,2,0,559,13.25
137,164,219,0,38,5,0,563,13.255
137,165,220,0,38,4,0,564,13.26
137,165,221,0,39,4,0,566,13.265
137,169,221,0,39,1,0,567,13.27
137,169,221,0,39,2,0,568,13.275
137,169,222,0,39,3,0,570,13.28
137,170,222,0,39,4,0,572,13.285
138,170,222,0,39,7,0,576,13.29
138,171,224,0,39,6,0,578,13.295
138,173,225,0,39,7,0,582,13.3
138,173,225,0,39,8,0,583,13.305
138,174,227,0,39,7,0,585,13.31
138,174,228,0,40,6,0,586,13.315
138,176,228,0,41,6,0,589,13.32
138,177,230,0,41,7,0,593,13.325
138,178,232,0,42,5,0,595,13.33
139,178,232,0,42,7,0,598,13.335
139,179,232,0,42,9,0,601,13.34
139,180,233,0,42,8,0,602,13.345
140,181,233,0,42,8,0,604,13.35
140,183,233,0,44,5,0,605,13.355
140,184,236,0,44,5,0,609,13.36
140,186,237,0,44,4,0,611,13.365
140,187,238,0,44,4,0,613,13.37
140,187,238,0,44,4,0,613,13.375
141,187,238,0,44,11,0,621,13.38
141,187,246,0,45,5,0,624,13.385
141,188,246,0,46,7,0,628,13.39
141,190,246,0,47,7,0,631,13.395
142,190,246,0,47,7,0,632,13.4
142,192,247,0,48,3,0,632,13.405
142,193,248,0,49,2,0,634,13.41
142,193,248,0,49,4,0,636,13.415
143,195,248,0,49,5,0,640,13.42
143,197,251,0,50,4,0,645,13.425
143,198,251,0,50,4,0,646,13.43
143,200,253,0,50,0,0,646,13.435
143,201,254,0,50,1,0,649,13.44
143,201,256,0,50,3,0,653,13.445
143,201,258,0,50,4,0,656,13.45
143,201,259,0,50,6,0,659,13.455
143,202,259,0,50,6,0,660,13.46
145,202,259,0,50,9,0,665,13.465
145,203,264,0,50,7,0,669,13.47
146,203,264,0,50,10,0,673,13.475
148,204,265,0,50,10,0,677,13.48
150,207,265,0,50,6,0,678,13.485
151,209,266,0,50,4,0,680,13.49
151,209,267,0,50,4,0,681,13.495
151,210,267,0,50,10,0,688,13.5
152,211,269,0,50,9,0,691,13.505
152,215,269,0,50,11,0,697,13.51
153,215,269,0,50,13,0,700,13.515
154,215,270,0,50,16,0,705,13.52
154,219,272,0,51,14,0,710,13.525
156,219,272,0,51,16,0,714,13.53
159,222,273,0,51,13,0,718,13.535
160,223,274,0,51,14,0,722,13.54
161,225,276,0,51,12,0,725,13.545
162,225,278,0,51,14,0,730,13.55
165,226,282,0,51,10,0,734,13.555
165,227,284,0,52,12,0,740,13.56
165,230,285,0,53,10,0,743,13.565
165,232,285,0,53,15,0,750,13.57
165,233,289,0,53,11,0,751,13.575
166,234,290,0,53,12,0,755,13.58
166,234,291,0,53,12,0,756,13.585
168,235,292,0,53,14,0,762,13.59
168,237,295,0,54,13,0,767,13.595
170,237,295,0,54,15,0,771,13.6
172,241,296,0,54,12,0,775,13.605
173,242,298,0,54,12,0,779,13.61
173,242,298,0,55,14,0,782,13.615
173,245,299,0,55,11,0,783,13.62
174,246,301,0,56,11,0,788,13.625
174,247,301,0,56,15,0,793,13.63
174,247,303,0,56,20,0,800,13.635
174,249,304,0,58,20,0,805,13.64
175,250,307,0,59,18,0,809,13.645
176,250,307,0,60,23,0,816,13.65
177,251,310,0,62,23,0,823,13.655
179,252,313,0,64,21,0,829,13.66
181,252,315,0,64,20,0,832,13.665
181,252,319,0,65,22,0,839,13.67
182,252,320,0,65,24,0,843,13.675
184,253,321,0,66,26,0,850,13.68
186,253,321,0,66,33,0,859,13.685
190,253,325,0,66,31,0,865,13.69
192,254,328,0,66,29,0,869,13.695
194,257,329,0,67,26,0,873,13.7
195,258,331,0,68,26,0,878,13.705
196,259,335,0,69,25,0,884,13.71
197,260,336,0,69,29,0,891,13.715
89,129,171,0,34,15,0,438,13.72
89,129,171,0,34,15,0,438,13.725
89,129,172,0,35,14,0,439,13.73
90,129,172,0,35,16,0,442,13.735
91,130,172,0,35,15,0,443,13.74
94,130,173,0,35,17,0,449,13.745
94,130,173,0,36,17,0,450,13.75
94,130,173,0,36,20,0,453,13.755
94,130,174,0,36,24,0,458,13.76
94,130,178,0,36,20,0,458,13.765
97,130,178,0,36,19,0,460,13.77
99,130,178,0,36,21,0,464,13.775
100,131,179,0,36,19,0,465,13.78
103,131,180,0,36,16,0,466,13.785
105,131,181,0,36,16,0,469,13.79
105,131,181,0,36,17,0,470,13.795
105,131,183,0,36,18,0,473,13.8
106,131,187,0,36,15,0,475,13.805
107,133,187,0,37,12,0,476,13.81
107,135,187,0,38,11,0,478,13.815
108,136,187,0,39,9,0,479,13.82
108,138,187,0,39,8,0,480,13.825
108,139,187,0,40,9,0,483,13.83
109,140,187,0,40,10,0,486,13.835
111,140,187,0,40,11,0,489,13.84
111,140,189,0,40,11,0,491,13.845
111,140,191,0,41,14,0,497,13.85
112,140,192,0,41,15,0,500,13.855
112,141,193,0,41,16,0,503,13.86
112,141,195,0,41,15,0,504,13.865
112,141,196,0,41,15,0,505,13.87
113,142,198,0,41,14,0,508,13.875
114,142,200,0,43,16,0,515,13.88
115,142,201,0,43,16,0,517,13.885
117,142,201,0,43,17,0,520,13.89
119,142,203,0,43,13,0,520,13.895
119,143,203,0,43,13,0,521,13.9
120,144,207,0,43,15,0,529,13.905
120,145,207,0,44,15,0,531,13.91
120,145,208,0,46,15,0,534,13.915
120,145,211,0,46,13,0,535,13.92
120,145,211,0,48,13,0,537,13.925
120,145,212,0,48,15,0,540,13.93
120,146,212,0,50,15,0,543,13.935
122,147,212,0,52,15,0,548,13.94
122,147,217,0,52,10,0,548,13.945
123,148,218,0,52,8,0,549,13.95
123,150,218,0,54,5,0,550,13.955
123,150,219,0,54,7,0,553,13.96
124,153,220,0,54,3,0,554,13.965
125,153,220,0,55,3,0,556,13.97
125,153,220,0,56,5,0,559,13.975
125,153,221,0,56,5,0,560,13.98
125,153,221,0,56,7,0,562,13.985
125,154,221,0,56,7,0,563,13.99
125,154,221,0,57,7,0,564,13.995
125,154,221,0,57,11,0,568,14
126,155,222,0,58,8,0,569,14.005
126,156,225,0,60,9,0,576,14.01
126,157,225,0,60,9,0,577,14.015
126,157,225,0,60,9,0,577,14.02
127,157,225,0,60,12,0,581,14.025
127,160,228,0,60,9,0,584,14.03
128,161,231,0,60,4,0,584,14.035
128,163,231,0,60,5,0,587,14.04
129,164,233,0,60,3,0,589,14.045
129,165,233,0,61,2,0,590,14.05
129,165,233,0,61,4,0,592,14.055
130,165,234,0,61,6,0,596,14.06
130,165,235,0,61,9,0,600,14.065
130,165,236,0,63,9,0,603,14.07
130,168,236,0,63,6,0,603,14.075
131,169,238,0,64,3,0,605,14.08
132,169,238,0,64,5,0,608,14.085
133,169,239,0,64,5,0,610,14.09
134,169,239,0,64,10,0,616,14.095
134,172,240,0,64,13,0,623,14.1
134,173,241,0,64,13,0,625,14.105
134,174,243,0,64,18,0,633,14.11
135,174,244,0,66,19,0,638,14.115
135,175,244,0,66,24,0,644,14.12
136,175,244,0,66,23,0,644,14.125
136,178,248,0,66,19,0,647,14.13
139,179,249,0,67,15,0,649,14.135
139,181,250,0,67,17,0,654,14.14
140,181,254,0,67,14,0,656,14.145
140,182,254,0,67,19,0,662,14.15
142,182,255,0,67,18,0,664,14.155
142,184,255,0,67,21,0,669,14.16
144,186,259,0,67,17,0,673,14.165
145,187,259,0,67,20,0,678,14.17
145,187,260,0,67,20,0,679,14.175
146,187,260,0,67,22,0,682,14.18
150,187,260,0,67,19,0,683,14.185
151,188,261,0,67,20,0,687,14.19
151,191,261,0,68,18,0,689,14.195
151,193,262,0,68,17,0,691,14.2
65,102,134,0,32,7,0,340,14.205
65,102,135,0,33,8,0,343,14.21
66,102,135,0,33,10,0,346,14.215
66,103,136,0,33,9,0,347,14.22
67,103,137,0,33,8,0,348,14.225
68,103,139,0,33,8,0,351,14.23
68,103,139,0,33,9,0,352,14.235
68,103,139,0,33,10,0,353,14.24
68,105,139,0,33,10,0,355,14.245
70,105,139,0,33,10,0,357,14.25
70,105,140,0,33,14,0,362,14.255
72,106,140,0,33,13,0,364,14.26
74,107,141,0,33,11,0,366,14.265
74,107,143,0,33,11,0,368,14.27
74,107,145,0,33,15,0,374,14.275
74,107,145,0,34,16,0,376,14.28
76,107,146,0,35,13,0,377,14.285
76,108,147,0,35,12,0,378,14.29
76,108,148,0,35,13,0,380,14.295
77,108,148,0,36,13,0,382,14.3
79,108,148,0,36,16,0,387,14.305
79,109,148,0,36,15,0,387,14.31
81,109,149,0,36,13,0,388,14.315
83,109,150,0,36,13,0,391,14.32
84,110,150,0,36,12,0,392,14.325
85,110,150,0,36,11,0,392,14.33
85,110,152,0,37,10,0,394,14.335
86,110,153,0,37,10,0,396,14.34
86,111,156,0,37,8,0,398,14.345
86,111,156,0,37,10,0,400,14.35
86,111,157,0,37,13,0,404,14.355
88,111,158,0,38,12,0,407,14.36
88,111,158,0,38,15,0,410,14.365
90,111,158,0,38,14,0,411,14.37
90,111,159,0,39,13,0,412,14.375
90,111,159,0,40,14,0,414,14.38
92,114,159,0,40,9,0,414,14.385
95,114,161,0,40,6,0,416,14.39
95,114,163,0,40,6,0,418,14.395
96,115,163,0,40,7,0,421,14.4
96,116,164,0,40,6,0,422,14.405
96,116,164,0,40,8,0,424,14.41
96,117,165,0,40,11,0,429,14.415
96,117,165,0,40,12,0,430,14.42
96,117,166,0,41,10,0,430,14.425
96,119,168,0,41,6,0,430,14.43
96,120,170,0,41,5,0,432,14.435
96,120,173,0,41,5,0,435,14.44
96,121,173,0,41,4,0,435,14.445
97,122,174,0,41,2,0,436,14.45
98,124,174,0,41,1,0,438,14.455
98,124,175,0,41,1,0,439,14.46
98,124,175,0,42,3,0,442,14.465
98,125,175,0,42,5,0,445,14.47
98,125,176,0,42,4,0,445,14.475
98,125,177,0,42,8,0,450,14.48
99,125,178,0,42,8,0,452,14.485
99,126,179,0,42,9,0,455,14.49
99,127,181,0,42,10,0,459,14.495
99,127,181,0,42,14,0,463,14.5
100,127,182,0,42,12,0,463,14.505
100,127,182,0,42,14,0,465,14.51
101,128,184,0,43,11,0,467,14.515
101,128,184,0,43,14,0,470,14.52
102,129,185,0,43,12,0,471,14.525
102,130,185,0,43,11,0,471,14.53
102,131,186,0,43,10,0,472,14.535
103,131,188,0,43,8,0,473,14.54
103,131,190,0,43,9,0,476,14.545
103,134,191,0,43,7,0,478,14.55
103,134,193,0,44,5,0,479,14.555
103,136,193,0,44,5,0,481,14.56
103,137,193,0,44,6,0,483,14.565
103,139,194,0,45,4,0,485,14.57
103,139,194,0,46,6,0,488,14.575
104,139,195,0,46,6,0,490,14.58
104,139,196,0,47,8,0,494,14.585
104,140,197,0,47,9,0,497,14.59
104,141,199,0,48,8,0,500,14.595
104,141,200,0,48,7,0,500,14.6
104,143,201,0,48,7,0,503,14.605
105,143,201,0,48,10,0,507,14.61
105,143,202,0,48,12,0,510,14.615
105,143,204,0,48,11,0,511,14.62
105,145,205,0,48,10,0,513,14.625
105,146,205,0,49,9,0,514,14.63
105,146,205,0,49,9,0,514,14.635
105,147,206,0,49,9,0,516,14.64
105,148,207,0,49,9,0,518,14.645
105,149,209,0,49,9,0,521,14.65
106,149,209,0,49,10,0,523,14.655
107,150,209,0,49,8,0,523,14.66
107,152,210,0,49,8,0,526,14.665
108,152,210,0,49,10,0,529,14.67
109,152,210,0,49,15,0,535,14.675
109,153,211,0,49,13,0,535,14.68
110,153,213,0,49,13,0,538,14.685
111,153,214,0,50,13,0,541,14.69
112,153,214,0,50,16,0,545,14.695
112,153,215,0,50,18,0,548,14.7
113,155,216,0,50,15,0,549,14.705
113,155,217,0,50,20,0,555,14.71
114,155,217,0,50,20,0,556,14.715
114,155,218,0,50,20,0,557,14.72
116,155,219,0,50,20,0,560,14.725
117,155,221,0,51,18,0,562,14.73
118,156,222,0,51,17,0,564,14.735
119,156,224,0,51,17,0,567,14.74
120,159,225,0,51,16,0,571,14.745
121,159,227,0,51,16,0,574,14.75
122,159,228,0,51,16,0,576,14.755
122,160,229,0,51,18,0,580,14.76
122,160,230,0,51,18,0,581,14.765
124,161,231,0,51,18,0,585,14.77
124,161,231,0,51,21,0,588,14.775
124,161,232,0,51,22,0,590,14.78
125,161,235,0,51,21,0,593,14.785
125,161,237,0,51,21,0,595,14.79
127,161,239,0,51,23,0,601,14.795
129,161,239,0,51,24,0,604,14.8
131,161,241,0,52,25,0,610,14.805
133,162,242,0,53,20,0,610,14.81
135,162,244,0,53,18,0,612,14.815
135,162,245,0,53,21,0,616,14.82
135,163,247,0,55,21,0,621,14.825
137,163,248,0,56,20,0,624,14.83
138,164,250,0,57,19,0,628,14.835
139,165,253,0,59,15,0,631,14.84
139,166,253,0,59,17,0,634,14.845
140,166,255,0,61,15,0,637,14.85
141,170,255,0,61,14,0,641,14.855
141,174,257,0,61,11,0,644,14.86
143,175,259,0,61,7,0,645,14.865
143,177,260,0,61,7,0,648,14.87
143,179,262,0,61,7,0,652,14.875
143,179,262,0,62,7,0,653,14.88
144,182,262,0,62,4,0,654,14.885
144,183,264,0,62,2,0,655,14.89
144,184,264,0,62,2,0,656,14.895
144,184,265,0,62,3,0,658,14.9
146,184,266,0,62,2,0,660,14.905
147,184,267,0,62,5,0,665,14.91
147,185,269,0,63,6,0,670,14.915
149,185,269,0,63,6,0,672,14.92
149,185,270,0,63,8,0,675,14.925
149,187,271,0,63,11,0,681,14.93
149,187,274,0,63,9,0,682,14.935
149,188,275,0,65,9,0,686,14.94
149,188,276,0,65,9,0,687,14.945
149,189,277,0,66,6,0,687,14.95
150,189,277,0,66,9,0,691,14.955
150,191,277,0,67,10,0,695,14.96
150,193,279,0,67,8,0,697,14.965
150,196,280,0,68,4,0,698,14.97
150,196,280,0,68,9,0,703,14.975
150,198,283,0,68,9,0,708,14.98
150,199,284,0,68,9,0,710,14.985
151,199,286,0,69,14,0,719,14.99
151,200,288,0,69,14,0,722,14.995
